0 0 0 0 0 0 0 0 0 0 0 0 0 0 0 0 0 0 0 0 0 0 0 0 0 0 0 0 0 0
0 0 0 0 0 0 0 0 0 0 0 0 0 0 0 0 0 0 0 0 0 0 0 0 0 0 0 0 0 0
2 0 0 0 0 0 0 0 0 0 0 0 0 6 0 0 0 0 0 0 0 0 0 0 0 0 0 0 0 2
2 1 0 0 0 0 0 0 0 0 0 1 5 6 5 1 0 0 0 0 0 0 0 0 0 1 0 0 0 2
2 0 1 4 4 4 3 4 4 4 4 4 1 3 1 4 4 4 4 4 3 4 4 4 1 0 0 0 0 2
2 0 0 1 5 0 3 0 8 0 0 0 5 3 5 0 0 0 8 0 3 0 5 1 0 0 0 0 0 2
2 0 0 0 1 4 3 4 3 4 4 4 1 3 1 4 4 4 3 4 3 4 1 0 0 0 0 0 0 2
2 0 0 0 0 1 0 0 3 0 0 7 0 3 0 7 0 0 3 0 0 1 0 0 0 0 0 0 0 2
2 0 3 4 4 4 1 0 3 0 1 4 4 3 4 4 1 0 3 0 1 4 4 4 4 4 4 3 0 2
2 0 3 4 3 0 0 1 3 1 0 0 0 0 0 0 0 1 3 1 0 0 0 0 0 3 4 3 0 2
2 0 0 0 3 0 0 1 3 1 0 0 0 0 0 0 0 1 3 1 0 0 0 0 0 3 0 0 0 2
2 0 3 4 3 0 0 1 3 1 0 9 0 5 0 0 0 1 3 1 1 1 1 0 0 3 4 3 0 2
2 0 3 0 0 0 0 1 3 1 1 1 1 1 1 1 1 1 3 1 1 1 1 0 0 0 0 3 0 2
2 0 3 4 3 0 0 1 3 1 0 1 1 1 1 1 0 1 3 1 1 5 1 0 0 3 4 3 0 2
2 0 0 5 3 0 0 1 3 1 0 1 1 5 1 1 0 1 3 1 1 1 1 0 0 3 5 0 0 2
2 0 3 4 3 8 0 1 3 1 0 1 1 1 1 1 0 1 3 1 0 0 0 0 8 3 4 3 0 2
2 0 3 4 4 4 4 0 3 0 4 0 0 0 0 0 4 0 3 0 4 4 4 4 4 4 4 3 0 2
2 0 3 0 0 0 0 1 3 1 0 1 1 1 1 1 0 1 3 1 0 0 0 0 0 0 0 3 0 2
2 2 2 2 2 2 2 2 2 2 2 2 2 2 2 2 2 2 2 2 2 2 2 2 2 2 2 2 2 2