0 0 0 0 0 0 0 0 0 0 0 0 0 0 0 0 0 0 0 0 0 0 0 0 0 0 0 0 0 0
0 0 0 0 0 0 0 0 0 0 0 0 0 0 0 0 0 0 0 0 0 0 0 0 0 0 0 0 0 0
2 0 0 0 0 0 0 0 0 0 0 0 0 8 0 0 0 0 0 0 0 0 0 0 8 0 0 0 0 2
2 7 3 7 3 7 3 7 3 7 3 7 3 7 3 7 3 7 3 7 3 7 3 7 3 7 3 7 6 2
2 7 3 7 3 7 3 7 3 7 3 7 3 7 3 7 3 7 3 7 3 7 3 7 3 7 3 7 6 2
2 5 3 1 3 0 3 1 3 5 3 1 3 0 3 1 3 5 3 1 3 0 3 1 3 5 3 1 6 2
2 7 3 1 3 7 3 1 3 7 3 1 3 7 3 1 3 7 3 1 3 7 3 1 3 7 3 1 6 2
2 7 3 1 3 7 3 1 3 7 3 1 3 7 3 1 3 7 3 1 3 7 3 1 3 7 3 1 6 2
2 7 3 1 3 7 3 1 3 7 3 1 3 7 3 1 3 7 3 1 3 7 3 1 3 7 3 1 6 2
2 0 3 1 3 5 3 1 3 0 3 1 3 5 3 1 3 0 3 1 3 5 3 1 3 0 3 1 6 2
2 7 3 1 3 7 3 1 3 7 3 1 3 7 3 1 3 7 3 1 3 7 3 1 3 7 3 1 6 2
2 7 3 1 3 7 3 1 3 7 3 1 3 7 3 1 3 7 3 1 3 7 3 1 3 7 3 1 6 2
2 5 3 0 3 0 3 0 3 0 3 0 3 0 3 0 3 0 3 0 3 0 3 0 3 0 3 1 6 2
2 3 1 1 1 1 1 1 1 1 1 1 1 1 1 1 1 1 1 1 1 1 1 1 1 1 1 1 6 2
2 3 0 0 0 0 0 0 0 0 0 5 0 8 0 5 0 0 0 5 0 8 0 0 0 0 0 0 6 2
2 3 2 2 2 2 2 2 2 2 2 2 2 2 2 2 2 2 2 2 2 2 2 2 2 2 2 2 6 2
2 3 5 0 0 0 0 0 0 0 9 0 0 0 0 0 0 0 0 0 0 0 0 0 0 0 0 5 6 2
2 1 1 1 1 1 1 1 1 1 1 1 1 1 1 1 1 1 1 1 1 1 1 1 1 1 1 1 1 2
2 2 2 2 2 2 2 2 2 2 2 2 2 2 2 2 2 2 2 2 2 2 2 2 2 2 2 2 2 2