0 0 0 0 0 0 0 0 0 0 0 0 0 0 0 0 0 0 0 0 0 0 0 0 0 0 0 0 0 0
0 0 0 0 0 0 0 0 0 0 0 0 0 0 0 0 0 0 0 0 0 0 0 0 0 0 0 0 0 0
2 2 2 2 2 2 2 2 2 2 2 2 2 2 2 2 2 2 2 2 2 2 2 6 0 0 0 0 2 2
2 2 0 0 0 0 0 0 0 0 0 8 0 0 0 0 0 0 0 0 0 0 0 6 0 0 0 0 2 2
2 2 0 0 0 0 3 1 2 1 1 2 2 1 3 2 0 0 0 0 0 0 0 6 0 0 0 0 2 2
2 2 0 0 0 0 3 0 0 0 0 0 0 6 3 2 1 2 1 1 2 2 1 6 0 0 0 0 2 2
2 2 0 1 1 2 3 0 0 0 0 0 3 6 3 1 0 1 0 8 1 4 4 4 4 4 4 4 2 2
2 2 5 0 0 0 3 0 0 0 5 6 3 6 1 1 0 1 0 2 1 0 0 0 0 0 0 5 2 2
2 2 0 0 0 0 3 0 0 0 3 6 3 6 1 0 0 1 0 0 1 0 0 0 0 0 0 8 2 2
2 2 3 0 0 0 3 0 0 0 3 6 3 6 1 0 5 1 9 0 1 0 0 0 0 0 0 1 2 2
2 2 3 0 0 0 3 0 0 0 3 6 2 1 1 0 0 1 1 0 1 0 0 0 0 0 5 1 2 2
2 2 3 2 2 2 2 7 1 2 2 6 2 0 0 0 0 0 1 0 1 0 0 0 0 0 1 1 2 2
2 2 3 0 4 4 4 4 4 4 4 4 2 4 4 4 4 4 1 0 1 0 0 5 0 0 0 1 2 2
2 2 3 0 0 0 0 0 5 0 0 3 0 0 0 0 0 1 1 0 1 0 0 0 0 1 1 1 2 2
2 2 3 0 0 3 2 7 2 2 2 3 2 2 2 1 3 1 0 0 1 0 0 0 5 1 0 0 2 2
2 2 3 0 0 3 2 0 0 0 2 3 2 0 0 1 3 1 1 1 1 7 1 2 1 0 5 0 2 2
2 2 3 0 0 3 2 0 0 0 2 3 2 5 0 1 3 0 0 0 0 0 0 0 0 1 1 2 2 2
2 2 3 0 5 3 2 0 8 0 2 3 2 1 1 1 1 1 2 2 1 1 1 2 1 1 1 1 2 2
2 2 2 2 2 2 2 2 2 2 2 2 2 2 2 2 2 2 2 2 2 2 2 2 2 2 2 2 2 2