0 0 0 0 0 0 0 0 0 0 0 0 0 0 0 0 0 0 0 0 0 0 0 0 0 0 0 0 0 0
0 0 0 0 0 0 0 0 0 0 0 0 0 0 0 0 0 0 0 0 0 0 0 0 0 0 0 0 0 0
2 0 0 0 0 0 0 0 0 0 0 0 0 0 0 0 0 0 0 3 0 0 0 6 0 0 0 0 0 2
2 0 0 0 0 0 0 0 0 4 4 0 0 0 0 0 0 0 0 3 0 0 0 6 0 0 0 0 0 2
2 5 0 0 0 5 0 0 4 4 0 3 0 0 0 0 0 4 4 3 0 0 5 6 8 0 0 0 0 2
2 1 1 1 1 3 4 4 0 0 0 3 0 8 0 0 4 4 4 1 7 1 1 3 1 3 0 0 0 2
2 0 0 0 0 3 0 0 2 1 7 1 3 0 0 4 4 4 5 1 5 0 0 6 1 3 0 0 0 2
2 7 7 1 1 1 3 0 0 5 0 0 3 4 3 2 2 0 2 1 1 1 1 1 1 3 0 0 0 2
2 7 5 0 0 0 3 0 0 2 0 0 0 0 3 0 0 0 2 2 2 2 0 4 4 3 0 0 0 2
2 0 7 5 0 0 3 0 0 0 0 0 0 5 3 0 5 0 0 0 0 0 3 2 0 0 0 0 0 2
2 0 0 1 5 0 3 1 7 1 1 3 2 2 2 2 2 2 3 1 7 2 3 2 0 0 0 0 0 2
2 0 0 3 1 5 3 0 0 0 0 3 0 0 5 0 0 0 3 0 0 0 3 2 0 0 0 0 0 2
2 0 0 3 0 7 3 2 0 0 0 3 1 7 1 1 1 1 3 1 1 2 3 2 0 0 0 0 0 2
2 0 0 3 0 4 3 0 0 5 0 3 0 0 5 0 0 0 3 0 0 2 3 2 0 0 0 0 0 2
2 0 0 3 2 0 5 0 0 2 0 3 1 1 1 1 7 1 3 0 2 5 3 5 2 0 0 0 0 2
2 0 0 3 0 0 2 0 0 0 0 3 0 0 5 0 0 0 3 0 2 2 3 2 2 0 0 0 0 2
2 0 0 3 0 0 0 0 0 0 0 3 1 1 7 1 1 1 3 0 0 8 3 0 0 0 0 0 0 2
2 1 1 1 1 1 1 1 1 1 1 3 0 0 8 0 0 9 3 1 1 1 1 1 1 1 1 1 1 2
2 2 2 2 2 2 2 2 2 2 2 2 2 2 2 2 2 2 2 2 2 2 2 2 2 2 2 2 2 2