0 0 0 0 0 0 0 0 0 0 0 0 0 0 0 0 0 0 0 0 0 0 0 0 0 0 0 0 0 0
0 0 0 0 0 0 0 0 0 0 0 0 0 0 0 0 0 0 0 0 0 0 0 0 0 0 0 0 0 0
2 0 0 0 5 0 0 0 0 0 0 4 0 4 0 0 8 0 0 0 4 0 0 0 0 0 0 4 8 2
2 3 1 1 1 0 3 1 1 1 1 5 1 5 1 1 1 1 1 3 0 4 0 0 0 0 4 0 3 2
2 3 0 0 5 0 3 1 1 1 1 1 1 1 1 1 1 1 1 3 0 4 5 0 4 0 5 0 3 2
2 3 1 1 1 0 3 1 1 5 1 1 1 1 1 5 1 1 1 3 4 0 0 4 0 4 0 4 3 2
2 3 0 0 5 0 3 1 1 1 1 1 1 1 1 1 1 1 1 3 0 5 0 0 0 5 0 0 3 2
2 3 1 1 1 0 3 1 5 1 1 1 1 1 1 1 5 1 1 3 0 4 4 0 0 4 0 0 3 2
2 3 0 0 5 0 3 1 1 1 1 1 1 1 1 1 1 1 1 3 0 4 0 5 0 4 5 4 3 2
2 3 1 1 1 0 3 1 1 5 1 1 1 1 1 5 1 1 1 3 0 0 0 4 0 0 4 0 3 2
2 3 0 0 5 0 3 1 1 1 1 1 1 1 1 1 1 1 1 3 0 0 4 0 4 0 0 0 3 2
2 3 1 1 1 0 3 1 1 1 5 1 1 1 5 1 1 1 1 3 4 0 0 4 0 4 0 4 3 2
2 3 0 0 5 0 3 1 1 1 1 1 1 1 1 1 1 1 1 3 0 0 5 0 0 0 4 0 3 2
2 3 1 1 1 0 3 1 1 1 1 5 1 5 1 1 1 1 1 3 0 0 0 4 4 0 5 0 3 2
2 3 0 0 5 0 3 1 1 1 1 1 1 1 1 1 1 1 1 3 0 4 0 0 4 0 4 0 3 2
2 3 1 1 1 0 3 1 1 1 5 1 1 1 5 1 1 1 1 3 0 5 0 4 0 4 0 4 3 2
2 3 0 8 0 0 3 1 1 1 1 1 1 1 1 1 1 1 1 3 0 0 0 0 0 9 0 0 0 2
2 3 1 1 1 1 3 1 1 5 1 1 1 1 1 5 1 1 1 3 1 1 1 1 1 1 1 1 1 2
2 2 2 2 2 2 2 2 2 2 2 2 2 2 2 2 2 2 2 2 2 2 2 2 2 2 2 2 2 2