0 0 0 0 0 0 0 0 0 0 0 0 0 0 0 0 0 0 0 0 0 0 0 0 0 0 0 0 0 0
0 0 0 0 0 0 0 0 0 0 0 0 0 0 0 0 0 0 0 0 0 0 0 0 0 0 0 0 0 0
2 0 0 0 0 0 0 0 0 0 0 0 0 0 0 0 0 0 0 0 0 0 0 0 0 0 0 0 6 2
2 0 0 0 0 0 0 0 0 0 0 0 0 0 0 0 0 0 0 0 0 0 0 0 0 0 0 0 6 2
2 0 0 0 0 0 0 0 0 0 0 0 0 0 0 0 0 0 0 0 0 0 8 4 5 5 5 4 6 2
2 0 0 5 4 5 4 0 0 0 0 0 0 0 0 0 0 0 0 0 0 0 3 5 1 1 1 5 3 2
2 5 3 1 0 1 0 5 4 0 0 0 0 0 0 0 0 0 0 0 0 5 3 1 1 1 1 1 3 2
2 1 3 0 0 0 0 1 0 0 0 0 0 0 0 0 0 0 0 5 0 1 3 1 1 5 1 1 3 2
2 0 3 0 0 0 0 0 0 5 4 0 0 0 0 0 0 0 0 1 3 4 3 1 1 1 1 1 3 2
2 0 3 0 0 0 0 0 0 1 0 0 0 0 0 0 0 5 0 4 3 0 0 5 1 1 1 5 0 2
2 0 3 0 0 0 0 0 0 0 0 0 0 0 0 0 0 1 3 0 0 0 0 0 0 0 0 0 0 2
2 0 3 0 0 0 0 0 0 0 0 5 0 0 0 0 0 0 3 0 0 0 0 5 5 5 5 0 0 2
2 0 3 0 0 0 0 0 0 0 0 1 0 0 0 5 0 4 3 0 0 0 5 1 1 1 1 5 0 2
2 0 3 0 0 0 0 0 0 0 0 0 0 0 0 1 3 0 0 0 0 0 1 1 1 1 3 7 0 2
2 0 3 0 0 0 0 0 0 0 0 0 5 4 0 0 3 0 0 0 0 0 1 1 1 3 7 1 0 2
2 0 3 0 0 0 0 0 0 0 0 0 1 0 5 4 3 0 0 0 0 0 1 1 3 7 1 1 0 2
2 0 3 0 0 0 0 0 0 0 0 0 0 5 1 0 3 0 0 0 0 0 1 3 7 1 1 1 0 2
2 0 3 0 0 9 0 0 0 0 0 0 0 1 0 0 3 0 8 0 0 0 3 7 1 1 1 1 0 2
2 2 2 2 2 2 2 2 2 2 2 2 2 2 2 2 2 2 2 2 2 2 2 2 2 2 2 2 2 2