0 0 0 0 0 0 0 0 0 0 0 0 0 0 0 0 0 0 0 0 0 0 0 0 0 0 0 0 0 0
0 0 0 0 0 0 0 0 0 0 0 0 0 0 0 0 0 0 0 0 0 0 0 0 0 0 0 0 0 0
2 0 0 0 0 0 0 8 0 0 0 6 0 0 0 0 0 0 0 6 0 0 0 8 0 0 0 0 0 2
2 0 0 0 0 0 0 0 0 0 0 0 6 0 0 0 0 0 6 0 0 0 0 0 0 0 0 0 0 2
2 0 0 0 0 0 0 0 0 0 0 0 0 6 0 0 0 6 0 0 0 0 0 0 0 0 0 0 0 2
2 0 0 0 0 0 0 0 0 0 0 5 1 1 1 3 1 1 1 5 0 0 0 0 0 0 0 0 0 2
2 0 0 0 0 0 0 0 0 0 0 1 5 1 5 3 5 1 5 1 0 0 0 0 0 0 0 0 0 2
2 0 0 5 0 0 0 0 0 0 1 5 3 0 3 1 3 0 3 5 1 0 0 0 0 5 0 5 0 2
2 0 0 1 1 3 1 3 1 1 1 1 1 1 3 0 3 1 1 1 1 1 1 3 1 3 1 1 0 2
2 0 5 1 0 3 1 3 0 0 0 0 0 0 3 3 3 0 0 0 0 0 0 3 1 3 5 1 0 2
2 0 1 0 3 3 1 3 3 3 3 3 3 3 3 3 3 3 3 3 3 3 3 3 1 3 3 0 1 2
2 0 1 3 8 5 0 1 3 3 3 3 3 3 3 1 3 3 3 3 3 3 3 1 0 5 8 3 1 2
2 0 0 1 1 1 3 0 1 3 0 5 0 0 3 0 3 0 0 5 0 3 1 0 3 1 1 1 0 2
2 0 0 0 5 1 1 3 1 1 1 1 1 1 1 3 1 1 1 1 1 1 1 3 1 1 5 0 0 2
2 0 0 0 1 1 0 3 0 0 0 0 0 5 0 3 0 5 0 0 0 0 0 3 0 1 1 0 0 2
2 0 0 0 1 0 3 1 1 3 3 3 3 3 3 1 3 3 3 3 3 3 1 1 3 0 1 0 0 2
2 0 5 0 0 3 1 1 1 3 3 3 1 3 3 3 3 3 1 3 3 3 1 1 1 3 9 5 0 2
2 1 1 1 1 1 1 1 1 1 1 1 1 1 1 1 1 1 1 1 1 1 1 1 1 1 1 1 1 2
2 2 2 2 2 2 2 2 2 2 2 2 2 2 2 2 2 2 2 2 2 2 2 2 2 2 2 2 2 2