0 0 0 0 0 0 0 0 0 0 0 0 0 0 0 0 0 0 0 0 0 0 0 0 0 0 0 0 0 0
0 0 0 0 0 0 0 0 0 0 0 0 0 0 0 0 0 0 0 0 0 0 0 0 0 0 0 0 0 0
2 5 8 0 0 0 0 0 1 1 1 1 1 1 1 1 1 1 1 1 1 1 1 1 1 1 1 1 1 2
2 1 1 3 0 0 0 0 1 1 1 1 1 1 1 1 1 1 1 1 1 1 1 1 1 1 1 1 1 2
2 3 1 1 1 1 3 0 0 0 0 1 1 1 1 1 1 1 1 1 1 1 1 1 1 1 1 1 1 2
2 3 1 1 1 1 1 1 1 3 0 8 0 0 1 1 1 1 1 1 1 1 1 1 1 1 1 1 1 2
2 3 1 1 1 1 1 0 1 1 1 1 3 0 0 0 0 1 1 1 1 1 1 1 1 1 1 1 1 2
2 3 1 1 1 1 1 0 1 1 1 1 1 1 1 3 0 0 0 0 1 1 1 1 1 1 1 1 1 2
2 3 1 1 1 1 1 0 1 1 1 1 1 1 1 1 1 1 3 0 8 0 0 1 1 1 1 1 1 2
2 3 1 1 1 1 0 5 0 1 1 1 1 1 1 1 1 1 1 1 1 3 0 0 0 0 1 1 1 2
2 3 1 1 1 1 1 1 1 0 5 0 1 1 1 1 1 1 1 1 1 1 1 1 3 0 0 0 0 2
2 3 1 1 1 1 1 0 1 1 1 1 0 5 0 1 1 1 1 1 1 1 1 1 1 1 1 1 3 2
2 3 1 1 1 1 1 0 1 1 1 1 1 1 1 0 5 0 1 1 1 1 1 1 1 1 1 1 3 2
2 3 1 1 1 1 1 0 1 1 1 1 1 1 1 1 1 3 0 5 0 1 1 1 1 1 1 1 3 2
2 3 1 1 1 1 1 0 1 1 1 1 1 1 1 1 1 3 1 1 1 0 1 1 1 1 1 1 3 2
2 3 5 0 0 0 5 0 0 0 5 0 0 0 5 0 1 3 1 1 1 0 1 1 1 1 1 1 3 2
2 1 1 1 1 1 1 1 1 1 1 1 1 1 1 0 0 3 1 1 1 0 0 0 0 0 0 9 3 2
2 1 1 1 1 1 1 1 1 1 1 1 1 1 1 1 1 1 1 1 1 1 1 1 1 1 1 1 1 2
2 2 2 2 2 2 2 2 2 2 2 2 2 2 2 2 2 2 2 2 2 2 2 2 2 2 2 2 2 2