0 0 0 0 0 0 0 0 0 0 0 0 0 0 0 0 0 0 0 0 0 0 0 0 0 0 0 0 0 0
0 0 0 0 0 0 0 0 0 0 0 0 0 0 0 0 0 0 0 0 0 0 0 0 0 0 0 0 0 0
2 0 0 0 0 0 0 0 0 0 0 0 0 0 0 8 0 0 5 0 0 0 0 0 0 0 0 0 0 2
2 0 0 0 0 0 0 0 0 0 5 0 0 1 1 1 1 1 1 3 1 0 5 0 0 0 0 0 0 2
2 0 0 0 0 0 1 1 1 7 1 1 1 1 0 0 0 0 0 3 1 1 1 1 1 7 1 0 0 2
2 0 0 0 0 0 1 0 0 0 0 0 0 1 0 0 0 0 0 3 1 0 0 0 0 0 1 0 0 2
2 0 0 0 0 0 1 0 8 5 0 0 0 1 0 0 0 0 0 3 1 0 0 0 0 0 1 0 0 2
2 0 1 1 1 1 1 1 1 1 0 5 0 1 5 0 0 1 3 1 1 1 1 1 5 5 1 0 0 2
2 0 1 0 0 0 0 0 0 1 1 1 7 1 1 1 1 1 3 0 0 0 0 1 7 1 1 1 1 2
2 0 1 0 0 0 0 0 0 1 0 0 0 0 0 5 0 1 3 0 8 5 0 0 0 0 4 0 1 2
2 0 1 0 0 0 0 0 0 1 0 0 0 0 3 1 1 1 1 1 1 1 1 1 1 1 0 3 1 2
2 0 1 0 0 0 5 0 5 1 0 0 0 0 3 1 0 0 0 0 0 0 0 0 0 5 0 3 1 2
2 0 1 0 0 1 1 1 1 1 0 0 0 0 3 1 0 5 0 0 3 1 3 0 3 1 1 1 1 2
2 0 1 1 1 1 0 0 0 1 0 5 1 3 1 1 1 1 0 0 3 1 1 1 7 1 0 0 0 2
2 0 0 0 0 1 0 5 0 1 1 1 1 3 0 0 0 1 0 5 3 1 0 0 0 0 0 0 0 2
2 0 0 0 0 1 1 1 1 1 0 0 1 3 0 0 0 1 1 1 7 1 0 0 0 0 0 0 0 2
2 0 0 0 0 0 0 0 0 0 0 0 0 3 0 0 0 0 0 0 9 0 0 0 0 0 0 0 0 2
2 2 1 2 1 2 1 2 1 2 1 2 1 2 1 2 1 2 1 2 1 2 1 2 1 2 1 2 1 2
2 2 2 2 2 2 2 2 2 2 2 2 2 2 2 2 2 2 2 2 2 2 2 2 2 2 2 2 2 2