0 0 0 0 0 0 0 0 0 0 0 0 0 0 0 0 0 0 0 0 0 0 0 0 0 0 0 0 0 0
0 0 0 0 0 0 0 0 0 0 0 0 0 0 0 0 0 0 0 0 0 0 0 0 0 0 0 0 0 0
2 2 0 0 0 0 0 0 0 0 0 0 0 0 0 0 0 0 0 0 0 0 0 0 0 0 0 0 6 2
2 2 0 0 0 0 0 5 5 5 5 8 0 8 0 8 0 0 0 0 0 0 9 0 0 0 0 0 6 2
2 2 1 1 1 1 1 1 1 1 1 1 7 1 1 1 1 1 1 1 1 1 1 1 1 1 1 1 3 2
2 0 0 0 0 0 0 0 0 0 0 0 0 0 0 0 0 0 0 0 0 0 0 0 0 0 0 0 3 2
2 0 0 0 0 2 0 5 0 0 5 0 0 0 0 0 0 0 5 0 0 0 0 0 0 5 2 0 3 2
2 0 0 0 0 2 1 1 1 1 1 1 1 7 1 1 1 1 1 1 1 7 1 1 1 1 2 0 3 2
2 0 0 0 0 0 0 0 0 0 0 0 0 0 0 0 0 0 0 0 0 0 0 0 0 0 0 0 3 2
2 0 0 0 0 0 0 2 0 0 5 0 0 0 0 5 0 0 0 0 0 5 0 0 2 0 0 0 3 2
2 0 0 0 0 0 0 2 1 1 1 7 1 1 1 1 1 1 7 1 1 1 1 1 2 0 0 0 3 2
2 0 0 0 0 0 0 0 0 0 0 0 0 0 0 0 0 0 0 0 0 0 0 0 0 0 0 0 3 2
2 0 0 0 0 0 0 0 2 0 0 5 0 0 0 0 0 5 0 0 0 0 5 2 0 0 0 0 3 2
2 0 0 0 0 0 0 2 2 1 1 1 1 1 1 1 1 1 1 1 1 1 1 2 0 0 0 0 3 2
2 0 0 0 0 0 0 0 0 0 0 0 0 0 0 0 0 0 0 0 0 0 0 0 0 0 0 0 3 2
2 0 0 0 0 0 0 0 0 0 0 0 0 0 0 0 0 0 0 0 0 0 0 0 0 0 0 0 3 2
2 5 5 5 5 0 0 0 8 0 0 0 0 0 0 0 0 0 0 8 0 0 0 0 0 3 2 0 3 2
2 1 1 1 1 1 1 1 1 1 1 2 2 2 2 2 2 1 1 1 1 1 1 1 2 2 2 0 3 2
2 2 2 2 2 2 2 2 2 2 2 2 2 2 2 2 2 2 2 2 2 2 2 2 2 2 2 2 2 2