0 0 0 0 0 0 0 0 0 0 0 0 0 0 0 0 0 0 0 0 0 0 0 0 0 0 0 0 0 0
0 0 0 0 0 0 0 0 0 0 0 0 0 0 0 0 0 0 0 0 0 0 0 0 0 0 0 0 0 0
2 2 2 2 2 2 2 2 2 2 2 2 2 6 0 0 2 2 2 0 0 0 0 0 0 0 2 1 2 2
2 1 1 1 1 1 1 1 2 1 1 2 2 6 0 0 1 1 2 0 0 0 0 0 0 0 1 2 1 2
2 0 0 0 5 0 0 1 2 1 2 1 2 6 0 0 2 1 2 0 0 0 0 0 0 0 1 0 0 2
2 3 2 1 1 1 7 1 0 0 0 0 2 6 0 8 0 1 2 0 0 0 0 0 0 5 1 0 5 2
2 3 1 1 1 1 0 0 0 4 4 4 4 3 1 1 2 1 2 7 1 1 1 1 1 3 2 0 3 2
2 3 1 0 5 1 0 4 4 4 2 1 2 3 1 0 0 0 0 7 2 1 1 1 1 3 1 0 3 2
2 3 1 1 1 4 4 4 0 0 2 1 2 3 1 4 4 4 4 7 2 1 1 1 1 3 2 1 3 2
2 3 1 1 4 4 4 0 0 0 0 0 0 3 2 0 0 0 0 0 5 0 1 1 2 3 1 1 3 2
2 3 1 4 4 5 0 0 0 1 1 2 1 3 1 0 0 0 0 7 1 1 2 2 1 3 1 1 3 2
2 3 4 4 0 2 4 4 4 4 4 4 4 3 0 0 0 4 4 4 4 4 0 1 1 3 0 1 3 2
2 0 0 0 2 1 8 0 0 5 0 0 2 3 7 1 1 2 0 9 0 5 0 0 0 3 1 1 3 2
2 1 1 7 1 2 1 1 0 2 1 1 2 3 7 1 1 2 2 1 2 2 1 2 0 0 0 0 3 2
2 1 1 7 1 2 0 0 0 0 0 0 2 3 7 0 0 0 0 8 0 5 0 2 1 1 1 1 1 2
2 1 1 7 1 2 4 4 4 4 4 4 4 3 7 1 1 0 0 1 1 1 1 2 0 0 5 0 1 2
2 1 1 0 0 0 0 0 5 0 0 0 2 3 0 0 0 0 0 0 0 0 0 0 1 1 1 1 1 2
2 1 2 1 1 1 1 2 1 1 3 0 0 3 0 0 3 1 1 1 2 1 1 1 1 1 1 1 1 2
2 2 2 2 2 2 2 2 2 2 2 2 2 2 2 2 2 2 2 2 2 2 2 2 2 2 2 2 2 2