0 0 0 0 0 0 0 0 0 0 0 0 0 0 0 0 0 0 0 0 0 0 0 0 0 0 0 0 0 0
0 0 0 0 0 0 0 0 0 0 0 0 0 0 0 0 0 0 0 0 0 0 0 0 0 0 0 0 0 0
2 1 1 1 1 1 1 1 1 1 1 1 1 0 0 0 0 1 1 1 1 1 1 2 2 1 1 1 6 2
2 1 4 4 4 4 4 4 4 4 4 4 4 4 4 4 4 4 4 4 4 4 4 0 1 1 0 1 6 2
2 1 0 3 1 1 1 1 1 1 1 1 1 3 0 0 6 1 4 4 4 4 4 3 4 4 4 4 6 2
2 9 0 3 5 2 5 5 5 5 0 0 0 3 0 0 6 1 5 0 0 5 5 3 0 0 0 5 6 2
2 1 1 3 1 1 1 1 1 2 1 1 1 3 0 0 6 1 1 1 3 1 1 1 7 1 3 1 6 2
2 1 0 3 3 3 3 3 0 2 0 0 5 3 0 0 6 1 5 0 3 4 4 4 4 4 3 0 6 2
2 1 5 0 0 2 5 3 0 0 5 5 1 3 0 0 6 1 2 0 3 0 2 2 2 0 3 5 6 2
2 1 1 1 1 1 1 1 7 1 1 1 1 3 0 0 6 1 5 0 3 8 0 0 5 5 3 2 3 2
2 1 0 0 5 2 5 5 0 2 0 0 1 3 0 0 6 1 1 1 1 1 1 3 1 1 1 1 3 2
2 1 0 0 2 2 2 2 0 2 0 0 1 3 4 4 3 1 5 0 0 0 0 3 0 0 5 5 6 2
2 1 0 5 5 5 0 5 5 2 5 0 1 3 5 8 3 1 2 5 0 0 0 3 0 1 1 1 3 2
2 1 3 1 1 1 7 1 1 1 1 3 1 1 1 1 1 1 1 1 1 3 1 1 1 1 1 1 3 2
2 1 3 4 4 4 4 4 4 4 4 3 1 1 1 0 4 4 4 4 4 3 4 2 0 4 4 4 3 2
2 1 3 0 5 0 0 5 5 5 0 3 0 0 5 3 0 5 0 5 0 3 0 2 3 5 0 5 1 2
2 1 1 3 1 1 3 2 1 3 1 1 1 7 1 3 1 1 2 1 7 1 1 1 1 1 3 1 1 2
2 0 5 3 5 5 3 8 0 3 0 0 0 0 0 3 0 0 0 0 0 0 0 0 5 5 3 5 5 2
2 2 2 2 2 2 2 2 2 2 2 2 2 2 2 2 2 2 2 2 2 2 2 2 2 2 2 2 2 2