0 0 0 0 0 0 0 0 0 0 0 0 0 0 0 0 0 0 0 0 0 0 0 0 0 0 0 0 0 0
0 0 0 0 0 0 0 0 0 0 0 0 0 0 0 0 0 0 0 0 0 0 0 0 0 0 0 0 0 0
2 0 0 6 0 0 0 0 0 0 0 0 0 0 0 0 0 0 0 0 0 0 0 0 0 0 0 0 0 2
2 0 0 6 0 0 0 0 0 0 0 0 0 0 0 0 0 0 0 0 0 0 0 0 0 0 0 0 0 2
2 0 0 6 0 0 0 0 0 0 4 4 4 4 4 0 0 0 0 0 0 0 0 4 4 4 4 4 3 2
2 0 8 3 0 0 0 0 4 0 0 0 0 0 0 3 0 0 4 4 0 8 3 0 0 0 0 0 3 2
2 7 1 3 4 4 4 3 0 1 7 1 1 0 0 3 1 1 0 0 1 1 3 0 1 1 7 1 1 2
2 7 1 0 0 0 0 3 1 1 7 1 1 1 0 3 1 1 0 0 1 1 3 0 1 1 7 1 0 2
2 7 1 0 0 0 0 3 1 1 8 4 0 0 0 3 1 1 0 0 1 1 3 0 1 1 0 0 0 2
2 7 1 0 0 0 0 3 1 1 3 0 1 1 0 3 1 1 0 0 1 1 3 4 0 1 0 0 0 2
2 7 1 0 5 0 0 3 1 1 3 5 1 1 0 3 1 1 5 0 1 1 5 3 7 7 5 9 0 2
2 7 0 4 4 3 4 3 1 1 3 0 1 1 0 3 1 1 0 0 1 1 0 3 1 1 1 1 0 2
2 1 1 0 3 3 0 0 1 1 3 0 0 1 0 3 1 1 0 0 1 1 0 3 1 1 1 1 0 2
2 1 1 3 3 0 0 0 1 1 3 0 7 0 4 3 1 1 0 0 1 1 0 3 1 1 0 0 0 2
2 1 1 3 0 0 0 0 1 1 3 0 1 1 0 0 1 1 0 0 1 1 0 3 1 1 0 0 0 2
2 1 1 3 0 5 4 4 1 1 3 0 0 5 0 0 0 1 0 5 1 0 0 3 0 0 0 5 0 2
2 1 1 1 1 1 3 0 1 1 1 1 1 1 3 0 0 1 1 7 1 0 0 3 1 1 1 1 3 2
2 1 1 1 1 1 3 0 5 1 1 1 1 0 3 0 0 5 1 7 5 0 0 3 1 1 1 1 1 2
2 2 2 2 2 2 2 2 2 2 2 2 2 2 2 2 2 2 2 2 2 2 2 2 2 2 2 2 2 2