0 0 0 0 0 0 0 0 0 0 0 0 0 0 0 0 0 0 0 0 0 0 0 0 0 0 0 0 0 0
0 0 0 0 0 0 0 0 0 0 0 0 0 0 0 0 0 0 0 0 0 0 0 0 0 0 0 0 0 0
2 6 0 0 0 0 0 0 0 0 0 0 0 0 0 0 0 0 0 0 0 0 0 0 0 0 0 0 0 2
2 6 4 4 4 4 4 4 4 4 4 4 4 4 4 4 4 4 4 4 4 4 4 4 4 4 4 4 4 2
2 3 1 0 8 0 0 0 1 0 0 0 0 0 0 0 0 0 0 0 0 0 1 0 0 0 0 0 1 2
2 3 0 1 1 1 1 1 0 0 0 0 0 0 0 0 0 0 0 0 0 0 0 1 1 1 1 1 0 2
2 3 0 1 0 1 1 1 0 0 0 0 0 0 0 0 0 0 0 0 0 0 0 1 5 1 1 1 0 2
2 3 0 1 1 1 1 1 0 8 0 0 0 0 8 0 0 0 0 0 0 8 0 1 1 1 1 1 0 2
2 3 0 1 1 1 0 1 7 1 1 1 1 1 1 1 1 1 1 1 1 1 1 1 1 1 0 1 0 2
2 3 0 1 1 1 1 1 7 1 1 1 0 5 1 1 0 5 1 1 1 1 1 1 1 1 3 1 0 2
2 3 0 1 1 1 1 1 7 1 1 1 1 1 1 1 1 1 1 1 1 1 1 1 1 1 3 1 0 2
2 3 0 1 1 1 1 1 7 1 1 1 1 1 1 1 1 1 1 1 1 1 1 1 1 1 3 1 0 2
2 3 0 1 1 1 1 1 7 1 1 1 1 0 0 0 0 1 1 1 1 1 1 1 1 1 3 1 0 2
2 3 0 1 1 1 1 1 7 1 1 1 1 0 0 0 0 1 1 1 1 1 1 1 1 1 3 1 0 2
2 3 0 1 1 1 1 1 7 1 1 1 1 0 0 0 5 3 1 1 1 1 1 1 1 1 3 1 0 2
2 3 0 0 0 0 0 0 0 0 0 0 0 1 1 1 1 3 4 4 4 4 4 4 4 4 3 0 0 2
2 3 0 0 0 0 0 0 0 0 0 0 2 2 2 2 0 0 0 0 0 0 0 0 0 0 0 0 0 2
2 3 0 0 0 0 0 0 9 0 0 2 2 2 2 0 0 0 0 0 0 8 0 0 0 0 0 0 0 2
2 2 2 2 2 2 2 2 2 2 2 2 2 2 2 2 2 2 2 2 2 2 2 2 2 2 2 2 2 2