0 0 0 0 0 0 0 0 0 0 0 0 0 0 0 0 0 0 0 0 0 0 0 0 0 0 0 0 0 0
0 0 0 0 0 0 0 0 0 0 0 0 0 0 0 0 0 0 0 0 0 0 0 0 0 0 0 0 0 0
2 1 1 1 1 1 6 1 1 1 1 1 1 1 1 1 1 1 1 1 1 1 1 1 0 1 1 1 1 2
2 0 0 0 0 1 6 1 0 4 4 4 4 4 4 4 0 0 0 0 0 0 0 0 0 0 0 0 1 2
2 6 1 1 6 0 6 1 0 1 5 0 0 0 1 3 1 0 0 0 0 0 0 0 0 0 8 0 1 2
2 6 0 1 1 1 1 1 0 1 1 1 1 1 1 3 1 1 1 1 1 5 0 1 3 1 1 1 1 2
2 1 6 0 0 0 0 5 4 4 4 1 1 1 1 3 1 1 1 1 1 1 1 1 3 1 0 1 1 2
2 1 1 1 1 1 1 1 0 0 0 1 0 0 1 3 1 1 1 0 1 1 1 1 3 1 0 1 1 2
2 0 0 0 0 0 0 0 8 0 0 0 0 0 1 3 1 1 1 0 1 1 0 1 3 1 5 0 1 2
2 3 1 1 1 1 1 1 1 3 1 3 5 0 1 3 1 1 1 0 1 1 0 1 3 1 1 1 1 2
2 3 0 0 0 0 0 0 0 3 1 1 1 1 1 3 1 1 1 5 0 1 0 1 3 1 1 0 1 2
2 3 0 0 0 0 0 0 0 0 0 1 1 1 1 3 1 1 1 1 1 1 0 1 3 1 1 5 1 2
2 3 0 0 0 0 0 0 0 1 0 0 0 0 0 3 0 0 0 0 0 0 0 0 3 0 0 0 1 2
2 3 1 1 1 3 1 1 1 1 3 1 2 1 2 1 2 1 2 1 2 1 2 1 3 1 2 1 2 2
2 3 1 1 1 3 1 1 1 1 3 1 1 1 1 1 1 0 0 1 1 1 1 1 3 1 2 1 2 2
2 3 0 0 0 3 0 0 0 0 3 1 1 1 1 1 1 1 0 0 1 1 1 1 3 0 0 0 0 2
2 3 1 1 1 1 1 1 1 1 3 1 1 1 1 1 1 1 1 5 0 1 1 1 1 1 1 1 3 2
2 3 9 0 0 0 0 0 0 0 3 0 5 0 1 1 1 1 1 1 0 0 8 0 0 0 0 0 3 2
2 2 2 2 2 2 2 2 2 2 2 2 2 2 2 2 2 2 2 2 2 2 2 2 2 2 2 2 2 2