0 0 0 0 0 0 0 0 0 0 0 0 0 0 0 0 0 0 0 0 0 0 0 0 0 0 0 0 0 0
0 0 0 0 0 0 0 0 0 0 0 0 0 0 0 0 0 0 0 0 0 0 0 0 0 0 0 0 0 0
2 6 0 0 0 0 0 0 0 0 0 0 0 0 0 0 0 0 0 0 0 0 0 0 0 0 0 0 6 2
2 6 4 4 4 4 4 4 4 4 4 4 4 4 4 4 4 4 4 4 4 4 4 4 4 4 4 4 6 2
2 3 3 0 0 0 0 0 0 0 0 0 0 0 0 0 0 0 0 0 0 0 0 0 0 0 0 3 3 2
2 3 0 0 1 7 1 1 0 0 0 0 1 1 1 7 1 1 0 0 1 1 1 1 1 1 0 0 3 2
2 3 0 0 1 0 0 1 1 0 0 0 1 0 0 0 0 1 0 0 1 0 0 0 0 7 0 0 3 2
2 3 0 0 1 0 0 0 1 1 0 0 1 0 0 0 0 0 0 0 1 0 0 0 0 0 0 0 3 2
2 3 0 0 1 0 0 0 0 1 0 0 1 0 0 0 0 0 0 0 1 0 0 0 0 0 0 0 3 2
2 3 0 0 1 0 0 0 5 1 0 0 1 0 0 0 0 5 0 0 1 0 0 0 0 0 0 0 3 2
2 3 0 0 1 0 0 0 1 1 0 0 1 0 0 0 1 1 0 0 1 0 0 0 0 5 0 0 3 2
2 3 0 0 1 5 0 1 1 0 0 0 1 0 0 0 5 1 0 0 1 5 0 0 5 1 0 0 3 2
2 3 0 0 1 1 1 1 0 0 0 0 1 1 1 7 1 1 0 0 1 1 7 1 1 1 0 0 3 2
2 3 0 0 0 0 0 0 9 0 0 0 0 0 0 0 0 0 0 0 0 0 0 0 0 0 0 0 3 2
2 3 0 3 1 1 1 1 1 1 0 0 1 1 1 1 1 1 0 0 1 3 1 1 1 1 0 0 3 2
2 3 0 3 1 0 0 0 5 1 0 0 1 1 1 1 1 1 3 0 1 3 1 1 5 1 0 0 3 2
2 3 8 3 1 0 0 0 0 1 0 8 1 1 0 5 1 1 3 0 0 3 1 1 1 1 0 0 3 2
2 1 1 1 1 1 1 1 1 1 1 1 1 1 1 1 1 1 1 1 1 1 1 1 1 1 1 1 1 2
2 2 2 2 2 2 2 2 2 2 2 2 2 2 2 2 2 2 2 2 2 2 2 2 2 2 2 2 2 2