0 0 0 0 0 0 0 0 0 0 0 0 0 0 0 0 0 0 0 0 0 0 0 0 0 0 0 0 0 0
0 0 0 0 0 0 0 0 0 0 0 0 0 0 0 0 0 0 0 0 0 0 0 0 0 0 0 0 0 0
2 2 2 2 2 2 2 2 2 2 2 2 2 0 6 0 2 2 2 2 2 2 2 2 2 2 2 2 2 2
2 2 4 4 4 4 4 4 4 4 3 1 2 4 6 4 2 1 3 4 4 4 4 4 4 4 4 4 2 2
2 2 0 0 0 0 0 0 5 0 3 1 4 4 6 4 4 1 3 0 5 0 0 0 0 0 0 0 2 2
2 2 0 0 0 5 0 0 1 1 3 4 4 5 6 5 4 4 3 1 1 0 0 5 0 0 0 0 2 2
2 2 0 0 5 1 1 7 4 3 3 1 2 1 6 1 2 1 3 3 4 1 7 1 0 5 0 0 2 2
2 2 0 5 1 1 4 4 3 4 1 7 4 3 6 3 4 7 1 4 3 4 4 1 1 1 5 0 2 2
2 1 5 1 1 4 4 3 4 4 4 4 4 3 6 3 4 4 4 4 4 3 4 4 4 1 1 5 2 2
2 1 7 4 4 4 3 4 4 4 4 4 4 3 6 3 4 4 4 4 4 4 3 4 4 4 4 7 1 2
2 1 4 4 4 3 8 4 4 4 4 4 4 3 6 3 4 4 4 4 4 4 8 3 4 4 4 4 1 2
2 1 0 0 0 3 1 1 1 1 1 1 7 3 9 3 7 1 1 1 1 1 1 3 0 0 0 0 1 2
2 1 0 5 0 3 0 0 0 0 0 0 0 1 1 1 0 0 0 0 0 0 0 3 0 0 5 0 1 2
2 3 0 0 0 3 0 0 0 0 8 0 0 1 5 1 0 0 8 0 0 0 0 3 0 0 0 0 3 2
2 3 4 4 4 3 1 7 1 1 1 1 1 3 0 3 1 1 1 1 1 7 1 3 4 4 4 4 3 2
2 3 0 5 0 0 3 0 0 0 0 0 0 3 0 3 0 0 0 0 0 0 3 0 0 5 0 0 3 2
2 3 0 0 0 0 3 0 0 5 0 0 0 3 0 3 0 0 5 0 0 0 3 0 0 0 0 0 3 2
2 1 1 1 1 1 1 1 1 1 2 1 1 1 1 1 1 1 2 1 1 1 1 1 1 2 2 2 2 2
2 2 2 2 2 2 2 2 2 2 2 2 2 2 2 2 2 2 2 2 2 2 2 2 2 2 2 2 2 2