0 0 0 0 0 0 0 0 0 0 0 0 0 0 0 0 0 0 0 0 0 0 0 0 0 0 0 0 0 0
0 0 0 0 0 0 0 0 0 0 0 0 0 0 0 0 0 0 0 0 0 0 0 0 0 0 0 0 0 0
2 0 4 4 4 4 4 4 4 4 1 0 0 0 0 0 0 0 0 0 0 8 0 0 0 0 0 0 0 2
2 3 0 0 0 0 0 0 0 0 1 0 0 5 0 0 0 0 3 1 1 1 1 3 0 1 0 1 3 2
2 3 0 7 7 7 7 7 7 0 1 1 1 1 1 3 2 0 3 2 0 0 0 3 0 1 0 1 3 2
2 3 0 7 7 7 7 7 7 0 1 0 0 5 0 3 2 0 3 2 3 2 0 3 0 1 0 1 3 2
2 3 0 7 7 7 7 7 7 0 1 3 1 1 1 1 2 0 3 2 3 2 0 3 0 1 0 1 3 2
2 3 0 7 7 5 5 7 7 0 1 3 0 5 0 0 2 0 3 2 3 2 0 3 0 1 0 1 3 2
2 3 0 7 7 7 7 7 7 0 1 1 1 1 1 3 2 0 3 2 3 2 0 3 0 1 0 1 3 2
2 3 0 7 7 7 7 7 7 0 1 0 0 5 0 3 2 0 3 2 3 2 0 3 0 1 5 1 3 2
2 3 0 0 0 0 0 0 0 8 1 3 1 1 1 1 2 0 3 2 3 2 0 3 0 1 1 7 3 2
2 3 1 1 1 1 1 1 1 1 1 3 0 5 0 0 2 0 3 2 3 2 0 3 0 0 0 0 3 2
2 3 1 1 1 1 1 1 1 1 1 1 1 1 1 3 2 1 1 2 3 2 1 1 1 1 1 1 3 2
2 3 1 1 1 1 1 1 1 1 1 0 0 5 0 3 2 2 2 2 3 2 2 2 2 1 1 1 3 2
2 3 1 1 5 5 1 1 1 1 1 3 1 1 1 1 2 0 5 0 6 0 5 0 2 5 1 1 3 2
2 3 1 1 1 1 1 1 1 1 5 3 2 1 2 2 2 2 2 2 2 2 2 2 2 1 1 1 3 2
2 3 2 2 2 2 2 2 2 2 2 2 0 0 0 0 0 0 0 5 0 0 8 5 0 0 0 0 3 2
2 3 0 9 0 0 0 0 0 0 0 0 3 1 1 1 1 1 1 1 1 1 1 1 1 1 1 1 1 2
2 2 2 2 2 2 2 2 2 2 2 2 2 2 2 2 2 2 2 2 2 2 2 2 2 2 2 2 2 2