0 0 0 0 0 0 0 0 0 0 0 0 0 0 0 0 0 0 0 0 0 0 0 0 0 0 0 0 0 0
0 0 0 0 0 0 0 0 0 0 0 0 0 0 0 0 0 0 0 0 0 0 0 0 0 0 0 0 0 0
2 6 0 0 0 0 0 0 0 0 0 0 0 0 0 0 0 0 0 0 0 0 0 0 0 0 0 0 0 2
2 6 0 0 0 0 1 0 0 0 8 0 1 0 0 0 0 0 0 0 8 0 0 0 8 0 0 0 0 2
2 6 4 4 4 4 4 4 5 3 1 3 0 1 1 3 1 1 6 6 1 6 6 1 1 3 0 0 0 2
2 3 0 0 0 0 0 0 1 3 0 1 3 1 0 3 1 0 5 1 0 5 1 0 0 3 0 0 0 2
2 3 0 9 0 0 0 0 0 1 0 0 1 0 3 1 0 3 1 0 0 1 0 0 0 3 0 0 0 2
2 1 1 1 1 1 0 0 0 0 1 1 0 3 1 0 0 1 0 0 1 0 0 0 0 3 0 0 0 2
2 0 0 0 0 1 0 0 0 5 1 0 3 1 0 5 1 0 0 1 0 4 4 4 0 3 0 0 0 2
2 0 0 0 1 0 0 0 0 1 0 3 3 3 0 1 0 0 0 0 1 0 0 1 1 1 1 1 3 2
2 0 5 1 0 0 0 5 1 0 0 1 3 3 1 0 0 1 1 0 0 7 0 0 0 0 0 0 3 2
2 1 1 0 0 0 0 1 0 5 1 0 3 1 0 0 1 0 0 1 0 0 1 0 0 0 0 0 3 2
2 1 0 0 0 5 1 0 0 1 0 3 1 0 0 1 0 0 0 0 1 0 0 1 5 0 0 0 3 2
2 0 0 0 0 1 0 5 1 0 3 1 0 5 1 0 0 3 1 0 0 1 5 0 1 0 0 0 3 2
2 0 0 5 1 0 0 1 0 3 1 0 0 1 0 0 0 3 0 1 0 0 1 0 0 1 0 0 3 2
2 0 0 1 0 5 1 0 3 1 0 0 1 0 0 0 0 3 0 0 1 5 0 1 0 0 1 0 3 2
2 0 1 0 0 1 0 3 3 0 0 0 0 0 5 0 0 3 0 0 0 1 0 0 0 0 0 1 3 2
2 0 0 0 0 0 0 3 1 1 1 1 1 1 1 1 1 1 1 1 1 1 1 1 1 1 0 0 3 2
2 2 2 2 2 2 2 2 2 2 2 2 2 2 2 2 2 2 2 2 2 2 2 2 2 2 2 2 2 2