0 0 0 0 0 0 0 0 0 0 0 0 0 0 0 0 0 0 0 0 0 0 0 0 0 0 0 0 0 0
0 0 0 0 0 0 0 0 0 0 0 0 0 0 0 0 0 0 0 0 0 0 0 0 0 0 0 0 0 0
2 2 2 2 2 2 2 2 2 2 2 2 2 2 2 2 0 0 6 0 2 2 2 2 2 2 2 2 2 2
2 0 0 8 3 0 0 0 0 0 0 3 4 4 4 0 0 0 6 0 3 0 0 0 0 0 0 5 0 2
2 2 2 2 6 1 1 2 2 2 2 2 1 7 1 2 2 2 6 0 3 2 2 2 2 0 3 2 1 2
2 2 4 4 3 0 0 0 0 0 0 0 3 4 4 4 4 3 0 0 3 0 0 0 1 1 1 1 1 2
2 2 0 0 3 0 0 0 0 0 0 0 5 0 1 5 1 3 8 0 3 0 0 5 0 0 0 1 1 2
2 5 0 7 3 0 0 0 0 0 0 0 3 0 0 0 0 2 1 3 0 2 2 1 1 1 1 2 1 2
2 2 1 7 3 4 4 4 4 4 4 4 3 4 4 4 4 4 2 3 4 4 4 4 4 4 4 3 2 2
2 1 5 0 2 0 0 0 0 0 0 0 3 0 0 0 5 3 2 2 2 0 0 0 0 0 0 3 1 2
2 2 2 7 1 0 0 0 0 5 5 5 3 0 0 0 0 3 2 4 4 4 4 0 0 5 0 3 3 2
2 2 0 0 0 0 0 0 0 0 0 0 3 0 0 0 0 3 2 3 0 5 0 0 0 7 1 2 3 2
2 1 1 1 7 1 1 0 0 0 0 0 3 0 9 0 0 3 2 3 0 0 0 0 0 0 0 0 3 2
2 1 3 4 4 4 4 0 3 2 1 1 1 2 1 1 7 2 2 3 0 0 0 0 0 0 0 0 3 2
2 1 3 5 0 0 0 1 3 0 0 0 0 0 0 0 0 3 1 3 0 0 2 1 1 1 1 0 3 2
2 1 3 2 4 4 1 1 1 3 0 0 0 0 0 0 0 3 2 3 0 0 1 0 5 0 2 0 3 2
2 1 3 0 0 1 1 1 2 1 3 0 0 8 0 0 0 3 0 3 0 0 0 1 2 2 1 2 2 2
2 2 1 1 1 1 1 2 2 2 2 1 1 1 1 1 1 1 1 1 1 1 1 1 1 2 1 1 1 2
2 2 2 2 2 2 2 2 2 2 2 2 2 2 2 2 2 2 2 2 2 2 2 2 2 2 2 2 2 2