0 0 0 0 0 0 0 0 0 0 0 0 0 0 0 0 0 0 0 0 0 0 0 0 0 0 0 0 0 0
2 1 1 6 1 2 1 2 1 2 1 2 1 2 2 1 0 1 6 1 2 0 1 1 6 1 1 1 1 2
2 1 1 6 1 1 1 1 1 1 2 1 2 2 3 2 0 2 6 2 1 0 1 0 6 0 0 3 1 2
2 1 2 6 0 0 0 0 0 0 1 2 0 0 3 0 0 0 6 0 5 0 0 8 6 0 0 3 1 2
2 1 1 1 7 1 1 3 4 4 4 4 4 4 3 1 1 7 1 1 1 1 1 1 1 1 1 3 1 2
2 0 9 0 5 0 0 3 5 3 1 2 5 0 3 0 2 0 0 2 1 2 0 0 1 0 0 3 1 2
2 1 1 1 1 1 3 1 1 3 2 1 2 0 0 5 0 2 0 0 0 0 2 0 4 4 4 3 1 2
2 0 0 2 1 0 3 2 0 3 2 2 2 1 2 2 1 0 2 0 0 4 4 4 4 4 1 3 1 2
2 5 0 8 0 0 3 0 0 3 0 0 1 4 4 4 4 4 4 4 4 4 2 0 5 1 1 3 1 2
2 1 7 2 1 1 3 0 0 3 5 2 2 1 5 0 1 2 5 0 0 2 0 0 1 1 0 3 1 2
2 2 7 0 2 0 3 0 0 5 2 1 2 2 1 5 0 2 1 4 4 4 3 1 0 0 0 3 1 2
2 0 0 1 0 0 3 0 5 2 0 5 5 5 0 2 5 0 0 2 0 0 3 0 0 0 0 3 0 2
2 3 4 4 4 4 3 5 2 0 3 1 2 1 0 0 2 5 0 0 0 1 3 1 1 1 1 1 1 2
2 3 0 3 0 0 2 2 4 4 3 0 0 0 0 0 0 2 0 0 5 0 3 0 2 2 2 2 2 2
2 3 0 3 1 2 1 5 5 0 3 4 4 3 0 0 3 0 1 1 1 1 3 0 0 2 0 0 1 2
2 3 0 3 5 0 5 1 1 5 8 5 5 3 4 4 3 0 0 1 1 2 3 0 0 0 8 5 1 2
2 1 1 1 1 1 1 1 1 1 1 1 1 3 0 5 3 5 1 1 1 1 1 1 1 1 1 1 1 2
2 2 2 2 2 2 2 2 2 2 2 2 2 2 2 2 2 2 2 2 2 2 2 2 2 2 2 2 2 2