0 0 0 0 0 0 0 0 0 0 0 0 0 0 0 0 0 0 0 0 0 0 0 0 0 0 0 0 0 0
2 0 0 0 0 0 0 0 0 0 0 0 0 0 0 0 0 0 0 0 0 0 2 2 2 2 2 2 3 2
2 4 4 4 4 4 4 4 4 4 4 4 4 4 4 0 0 8 0 0 0 0 0 0 0 0 0 0 3 2
2 3 0 0 0 0 0 0 0 0 0 0 0 0 3 2 2 2 2 2 2 2 0 3 1 0 3 6 1 2
2 3 0 8 3 2 3 0 0 0 0 0 0 0 3 4 4 4 4 4 3 0 1 3 0 1 3 0 0 2
2 2 2 2 2 2 3 2 3 2 0 9 0 0 0 0 0 0 0 0 3 0 0 1 1 0 6 1 7 2
2 3 4 4 4 4 3 0 3 1 7 1 1 1 2 2 2 0 1 1 3 0 1 1 3 6 6 1 7 2
2 3 0 0 0 0 3 0 3 1 0 5 1 0 0 0 5 0 0 0 3 0 1 0 3 1 4 4 7 2
2 3 0 0 0 0 0 0 3 1 0 0 5 1 1 1 1 0 2 2 3 0 5 3 1 5 0 5 5 2
2 3 0 0 0 0 0 0 3 1 0 8 1 1 1 1 1 0 0 0 3 0 1 3 1 0 0 0 1 2
2 3 7 5 0 0 0 0 0 1 0 1 1 1 1 1 5 0 2 2 3 6 6 3 1 3 1 1 1 2
2 3 0 1 0 0 0 0 0 1 0 5 1 1 1 1 1 0 5 0 3 0 0 1 0 3 1 1 0 2
2 3 0 0 1 0 0 0 0 1 0 1 1 1 1 1 1 0 3 2 3 0 1 1 1 3 0 1 1 2
2 3 0 0 0 1 0 0 0 1 3 0 5 1 5 0 1 0 3 0 3 0 0 1 0 3 1 0 5 2
2 3 0 0 0 0 1 0 0 0 3 1 1 1 1 1 1 0 3 2 3 0 1 0 1 1 0 1 1 2
2 3 0 0 0 0 0 0 0 1 0 0 0 0 0 0 0 0 0 0 3 0 0 0 0 0 0 0 0 2
2 1 1 2 2 2 1 1 1 1 1 1 1 1 1 2 2 2 2 1 2 1 2 2 2 1 2 2 2 2
2 2 2 2 2 2 2 2 2 2 2 2 2 2 2 2 2 2 2 2 2 2 2 2 2 2 2 2 2 2