0 0 0 0 0 0 0 0 0 0 0 0 0 0 0 0 0 0 0 0 0 0 0 0 0 0 0 0 0 0
0 0 0 0 0 0 0 0 0 0 0 0 0 0 0 0 0 0 0 0 0 0 0 0 0 0 0 0 0 0
2 0 0 0 0 0 0 0 0 0 0 6 0 0 0 0 0 0 0 0 0 0 0 0 0 0 0 0 0 2
2 0 0 0 0 0 0 0 0 0 0 6 0 0 0 0 0 0 0 0 0 0 0 0 0 0 0 0 0 2
2 0 5 0 8 0 5 0 0 0 2 3 2 0 0 0 4 4 4 4 4 4 4 4 0 9 0 0 0 2
2 3 2 1 1 1 2 2 1 0 2 3 5 0 0 0 0 0 0 0 0 0 0 1 1 1 1 0 0 2
2 3 2 0 0 0 0 0 0 0 2 3 2 0 0 0 0 5 0 0 0 0 0 0 0 0 0 0 5 2
2 3 2 4 4 4 4 0 0 0 2 3 2 0 0 1 1 1 1 4 4 4 0 0 0 0 0 0 3 2
2 3 2 0 0 0 0 0 0 5 2 3 2 0 0 5 0 0 0 0 0 0 0 0 0 5 0 0 3 2
2 3 0 0 5 2 1 1 1 2 2 3 2 1 1 1 0 0 0 0 0 0 3 1 1 1 1 0 3 2
2 3 2 1 2 2 0 0 0 0 2 3 2 0 0 0 0 0 0 8 5 0 3 1 0 0 0 0 3 2
2 3 2 4 4 4 4 4 4 4 5 3 2 0 0 0 1 1 1 1 1 1 1 1 0 0 0 0 3 2
2 3 2 0 0 0 0 5 0 0 2 3 2 0 0 0 5 0 0 0 0 0 0 0 0 5 0 0 3 2
2 3 2 0 0 0 2 1 1 1 2 3 2 4 4 1 1 1 1 4 4 0 0 3 1 1 0 0 3 2
2 3 2 5 0 0 0 0 0 0 2 3 2 0 0 0 0 0 0 0 0 5 0 3 0 0 0 0 3 2
2 3 2 1 1 0 0 0 0 0 2 3 2 0 0 0 0 0 0 1 1 1 1 1 0 0 0 0 3 2
2 3 0 0 0 0 0 8 0 0 0 3 0 0 0 0 0 0 0 0 0 0 0 0 0 0 0 0 3 2
2 2 1 1 1 2 1 1 1 1 2 2 2 2 1 1 1 2 1 1 1 1 2 2 1 1 2 2 2 2
2 2 2 2 2 2 2 2 2 2 2 2 2 2 2 2 2 2 2 2 2 2 2 2 2 2 2 2 2 2