0 0 0 0 0 0 0 0 0 0 0 0 0 0 0 0 0 0 0 0 0 0 0 0 0 0 0 0 0 0
2 2 6 0 0 0 0 0 0 0 0 0 0 0 0 0 0 0 0 0 0 0 0 0 0 0 0 6 2 2
2 2 6 0 0 8 5 5 5 5 5 5 5 5 0 5 5 5 5 5 5 5 5 5 8 0 0 6 2 2
2 2 2 2 2 2 2 2 2 2 2 2 2 2 6 2 2 2 2 2 2 2 2 2 2 2 2 2 2 2
2 0 0 0 0 0 0 5 0 5 0 0 0 0 6 0 0 0 0 0 5 0 0 5 0 0 0 0 0 2
2 0 0 0 0 2 3 2 2 2 2 0 0 0 6 0 0 0 2 3 2 2 2 2 2 0 0 0 0 2
2 0 0 0 0 0 3 5 0 5 0 0 0 0 6 0 0 0 0 3 5 0 0 5 0 0 0 0 0 2
2 0 0 0 2 2 2 2 2 2 3 2 0 0 6 0 0 2 2 2 2 2 2 2 3 2 0 0 0 2
2 0 0 0 0 0 0 5 0 5 3 0 0 0 6 0 0 0 0 0 5 0 0 5 3 0 0 0 0 2
2 0 0 2 3 2 2 2 2 2 2 2 2 0 6 0 2 3 2 2 2 2 2 2 2 2 2 0 0 2
2 0 0 0 3 0 0 5 0 5 0 0 0 0 6 0 0 3 0 0 5 0 0 5 0 0 0 0 0 2
2 0 2 2 2 2 2 2 2 2 2 2 3 2 6 2 2 2 2 2 2 2 2 2 2 2 3 2 0 2
2 0 0 0 0 0 0 5 0 0 5 0 3 0 6 0 0 0 0 5 0 0 0 5 0 0 3 0 0 2
2 0 2 3 2 2 2 2 2 2 2 2 2 2 6 2 2 2 2 2 2 2 2 2 2 2 2 2 0 2
2 0 0 3 0 0 0 0 0 0 0 0 0 0 0 0 0 0 0 0 0 0 0 0 0 0 0 0 0 2
2 0 0 3 0 0 0 5 0 0 5 0 0 0 0 0 0 9 0 5 0 0 0 5 0 0 0 0 8 2
2 1 1 1 1 1 1 1 1 1 1 1 1 1 1 1 1 1 1 1 1 1 1 1 1 1 1 1 1 2
2 2 2 2 2 2 2 2 2 2 2 2 2 2 2 2 2 2 2 2 2 2 2 2 2 2 2 2 2 2