0 0 0 0 0 0 0 0 0 0 0 0 0 0 0 0 0 0 0 0 0 0 0 0 0 0 0 0 0 0
2 1 1 1 1 1 1 1 1 1 1 1 1 1 1 1 1 1 1 1 1 1 1 1 1 1 1 1 6 2
2 1 0 0 0 3 3 3 3 3 3 3 3 3 3 3 3 3 3 3 3 3 3 3 0 0 0 1 6 2
2 1 0 9 0 3 0 3 3 3 0 0 0 0 3 0 0 0 3 3 0 0 0 3 0 8 0 1 6 2
2 1 1 1 1 3 0 3 3 3 0 3 3 0 3 0 3 3 0 3 0 3 3 3 1 1 1 1 6 2
2 1 0 0 0 3 0 3 3 3 0 3 3 0 3 0 3 3 0 3 0 0 0 3 0 0 0 1 6 2
2 1 0 8 0 3 0 3 3 3 0 3 3 0 3 0 3 3 0 3 0 3 3 3 0 8 0 1 6 2
2 1 1 1 1 3 0 0 0 3 0 0 0 0 3 0 0 0 3 3 0 0 0 3 1 1 1 1 6 2
2 3 3 3 3 3 3 3 3 3 3 3 3 3 3 3 3 3 3 3 3 3 3 3 3 3 3 3 6 2
2 3 0 5 0 3 0 5 0 3 0 5 0 0 3 0 0 5 0 3 0 5 0 3 0 5 0 3 6 2
2 3 3 3 3 3 3 3 3 3 3 3 3 3 3 3 3 3 3 3 3 3 3 3 3 3 3 3 6 2
2 3 0 0 0 3 0 3 0 3 0 3 3 0 3 0 3 3 0 3 0 0 0 3 0 0 0 3 6 2
2 3 0 3 0 3 0 3 0 3 0 0 3 0 3 0 0 3 0 3 0 3 3 3 0 3 0 3 6 2
2 3 0 0 3 3 0 3 0 3 0 3 0 0 3 0 3 0 0 3 0 0 0 3 0 0 3 3 6 2
2 3 0 3 0 3 0 3 0 3 0 3 3 0 3 0 3 3 0 3 0 3 3 3 0 3 0 3 6 2
2 3 0 3 0 3 0 0 0 3 0 3 3 0 3 0 3 3 0 3 0 0 0 3 0 3 0 3 6 2
2 3 3 3 3 3 3 3 3 3 3 3 3 3 3 3 3 3 3 3 3 3 3 3 3 3 3 3 6 2
2 2 2 2 2 2 2 2 2 2 2 2 2 2 2 2 2 2 2 2 2 2 2 2 2 2 2 2 2 2