0 0 0 0 0 0 0 0 0 0 0 0 0 0 0 0 0 0 0 0 0 0 0 0 0 0 0 0 0 0
2 0 0 0 0 0 0 0 0 0 5 0 0 0 5 0 0 0 0 0 0 0 0 0 0 0 0 0 0 2
2 0 5 0 0 0 5 0 0 0 1 1 3 1 1 0 0 0 5 0 0 0 5 0 0 0 0 5 0 2
2 0 1 1 3 1 1 0 0 0 0 0 3 0 0 0 0 0 1 1 3 1 1 0 0 0 1 3 1 2
2 0 0 0 3 0 0 0 0 0 0 3 0 0 0 0 0 0 0 0 3 0 0 0 0 0 0 3 0 2
2 0 0 0 0 3 0 0 0 0 0 0 3 0 0 0 0 0 0 0 0 3 0 0 0 0 3 0 0 2
2 0 0 0 3 0 0 0 0 0 0 0 8 3 0 0 0 5 5 0 0 0 3 0 0 0 0 3 0 2
2 0 0 3 0 0 0 0 0 0 0 0 3 0 0 0 0 1 1 0 0 3 0 4 4 4 4 0 3 2
2 0 0 0 3 0 0 0 0 0 0 3 0 0 0 0 0 0 0 0 3 0 0 0 0 0 0 3 0 2
2 0 0 0 0 3 0 0 0 0 0 0 3 0 4 4 4 4 4 4 0 3 0 0 0 0 3 9 0 2
2 0 0 0 3 0 4 4 4 4 4 0 8 3 0 0 0 0 0 0 0 0 3 0 0 0 0 1 1 2
2 0 0 3 0 0 0 5 5 0 0 0 3 0 0 0 0 0 0 0 0 3 0 0 0 0 0 0 0 2
2 0 0 0 3 0 0 1 1 0 0 3 0 0 0 0 0 0 0 0 3 0 0 0 0 0 0 0 0 2
2 0 0 8 0 3 0 0 0 0 0 0 3 0 0 0 0 0 0 0 0 3 0 8 0 0 0 0 0 2
2 1 1 1 1 1 7 7 7 7 7 7 7 7 7 7 7 7 7 7 7 1 1 1 1 1 1 1 3 2
2 0 0 0 0 0 0 0 0 0 0 0 0 0 0 0 0 0 0 0 0 0 0 0 0 0 0 0 3 2
2 1 1 1 1 1 1 1 1 1 1 1 1 1 1 1 1 1 1 1 1 1 1 1 1 1 1 1 1 2
2 2 2 2 2 2 2 2 2 2 2 2 2 2 2 2 2 2 2 2 2 2 2 2 2 2 2 2 2 2