0 0 0 0 0 0 0 0 0 0 0 0 0 0 0 0 0 0 0 0 0 0 0 0 0 0 0 0 0 0
2 0 0 0 0 0 0 2 4 4 4 4 4 4 4 0 0 4 4 4 0 3 3 1 1 3 0 0 6 2
2 5 0 0 0 8 5 2 4 4 4 4 4 4 5 1 1 0 0 0 3 3 1 1 3 3 0 0 6 2
2 1 1 1 3 1 1 2 0 0 0 0 0 5 1 1 0 0 0 3 3 1 1 3 3 5 0 0 6 2
2 0 0 0 3 0 0 2 0 0 0 0 5 1 1 0 0 0 3 3 1 1 3 3 5 0 2 2 6 2
2 5 0 0 3 0 5 2 0 0 0 5 1 1 0 0 0 3 3 1 1 3 3 5 0 2 2 0 6 2
2 1 1 1 3 1 1 2 0 0 5 1 1 0 0 0 3 3 1 1 3 3 5 0 2 2 0 0 6 2
2 0 0 9 3 0 0 2 0 5 1 1 0 0 0 3 3 1 1 3 3 5 0 2 2 0 5 5 6 2
2 1 1 1 3 0 5 2 5 1 1 0 0 0 3 3 1 1 3 3 5 0 2 2 0 3 1 1 0 2
2 1 1 1 3 1 1 2 1 1 0 0 0 3 3 1 1 3 3 5 0 2 2 0 0 3 5 5 0 2
2 1 5 1 3 0 0 2 0 5 0 0 3 3 8 0 3 3 5 0 2 2 0 3 1 1 1 1 0 2
2 1 1 1 3 0 5 2 1 1 1 1 1 1 1 1 1 1 1 3 2 0 0 3 5 0 8 5 0 2
2 5 1 1 3 1 1 2 4 4 4 4 4 4 4 4 4 4 4 3 2 0 3 1 1 1 1 1 0 2
2 1 1 1 3 0 5 2 5 0 5 0 0 3 0 0 0 0 0 0 2 0 3 5 0 0 0 5 0 2
2 1 2 2 2 2 2 2 1 1 1 0 0 3 0 1 1 1 1 0 2 0 3 1 1 1 1 1 0 2
2 0 0 0 0 0 0 0 0 0 0 0 8 3 1 1 5 5 1 1 2 0 3 5 0 0 0 5 0 2
2 1 1 1 1 1 1 1 1 1 1 1 1 2 1 1 1 1 1 1 2 0 1 1 1 1 1 1 1 2
2 2 2 2 2 2 2 2 2 2 2 2 2 2 2 2 2 2 2 2 2 2 2 2 2 2 2 2 2 2