0 0 0 0 0 0 0 0 0 0 0 0 0 0 0 0 0 0 0 0 0 0 0 0 0 0 0 0 0 0
2 0 0 0 0 0 4 0 0 0 0 0 4 0 4 0 0 0 0 0 0 4 0 0 5 0 0 5 0 2
2 4 0 0 0 4 0 4 0 0 0 4 0 3 0 4 0 0 0 0 4 0 3 1 1 1 1 1 1 2
2 0 4 0 4 0 0 0 4 0 4 0 0 3 0 0 4 0 0 4 0 0 3 0 0 0 0 0 0 2
2 0 0 4 0 0 0 0 0 4 0 0 0 3 0 0 0 4 4 0 0 0 3 0 0 8 0 0 0 2
2 0 5 0 0 0 5 0 0 5 0 0 0 3 0 0 0 4 0 0 0 0 3 2 2 2 2 2 3 2
2 2 2 2 2 2 2 2 7 2 2 2 2 2 2 3 4 0 0 0 0 0 3 2 0 5 0 2 3 2
2 0 0 0 0 0 0 0 0 0 0 0 0 0 0 2 0 0 0 0 0 0 3 2 3 2 5 2 3 2
2 0 0 0 0 0 0 0 0 0 0 0 0 0 5 2 0 0 9 0 5 0 3 2 3 2 5 2 3 2
2 3 1 1 1 1 1 1 1 1 1 1 3 1 2 2 3 1 1 1 1 4 3 2 3 2 5 2 3 2
2 3 0 0 0 0 0 8 0 0 0 0 3 1 1 3 3 0 0 0 0 0 3 2 3 2 5 2 3 2
2 3 0 0 0 0 1 1 0 0 0 0 3 1 1 3 0 0 0 5 8 0 0 2 3 2 5 2 3 2
2 3 0 1 1 1 0 0 1 1 1 0 3 1 1 2 2 1 1 1 1 1 3 2 3 4 4 4 4 2
2 3 0 1 1 1 0 0 1 1 1 0 3 1 1 0 0 0 0 0 0 0 3 0 0 0 0 0 0 2
2 3 0 1 1 1 5 5 1 1 1 0 3 1 0 0 0 0 0 4 4 5 3 0 1 1 1 1 0 2
2 3 0 5 0 5 1 1 5 0 5 0 3 1 1 0 0 3 1 0 0 1 3 1 1 5 5 1 1 2
2 1 1 1 1 1 1 1 1 1 1 1 1 1 1 1 1 1 1 1 1 1 1 1 1 1 1 1 1 2
2 2 2 2 2 2 2 2 2 2 2 2 2 2 2 2 2 2 2 2 2 2 2 2 2 2 2 2 2 2