0 0 0 0 0 0 0 0 0 0 0 0 0 0 0 0 0 0 0 0 0 0 0 0 0 0 0 0 0 0
2 0 0 3 0 0 0 8 0 0 0 0 4 0 0 0 8 4 3 0 0 0 0 3 4 0 0 0 5 2
2 0 4 3 0 0 0 4 3 4 0 0 0 4 0 0 4 0 3 4 0 0 0 3 0 4 0 0 3 2
2 4 0 3 0 0 4 0 3 0 4 0 0 0 0 4 0 0 3 0 4 0 0 3 0 0 4 0 3 2
2 5 0 3 0 4 0 0 3 0 0 4 0 0 4 0 0 0 3 0 0 4 5 3 0 0 0 4 3 2
2 0 0 3 4 0 0 4 3 0 0 0 4 4 0 0 0 0 3 5 0 0 4 3 0 0 0 0 3 2
2 3 4 0 0 0 4 0 3 4 0 0 4 4 0 0 4 0 3 4 4 4 4 4 4 0 4 0 0 2
2 3 0 4 0 0 0 4 3 0 0 4 5 0 4 0 0 0 3 0 0 4 0 0 0 3 0 4 0 2
2 3 4 0 4 0 0 0 3 5 4 4 3 0 0 4 0 0 3 0 0 0 0 0 4 3 0 0 4 2
2 3 0 4 0 4 0 0 3 4 4 0 3 0 0 0 4 0 3 0 0 0 0 4 0 3 0 0 4 2
2 3 4 0 5 0 4 8 3 4 0 0 3 0 4 0 0 4 3 4 0 0 4 0 0 3 0 0 4 2
2 3 0 4 3 0 0 4 0 0 0 0 3 0 0 0 4 0 0 0 4 0 0 0 0 3 0 0 4 2
2 3 4 0 3 0 0 0 4 0 0 0 3 0 0 4 0 4 0 0 0 4 0 0 0 3 0 0 4 2
2 3 0 4 3 0 4 0 0 4 0 0 3 5 4 0 0 0 4 0 0 0 4 0 0 3 0 5 4 2
2 3 4 0 3 0 0 0 4 0 4 0 3 4 0 4 0 0 5 4 0 0 0 4 0 3 0 4 0 2
2 3 0 4 3 0 0 4 0 0 0 4 3 0 0 0 0 0 4 0 4 0 4 0 4 3 4 0 0 2
2 0 0 0 3 0 0 0 0 0 5 0 0 0 0 0 5 9 0 0 0 0 0 0 0 3 0 0 0 2
2 2 2 2 2 2 2 2 2 2 2 2 2 2 2 2 2 2 2 2 2 2 2 2 2 2 2 2 2 2