0 0 0 0 0 0 0 0 0 0 0 0 0 0 0 0 0 0 0 0 0 0 0 0 0 0 0 0 0 0
2 3 0 0 0 4 0 0 0 0 0 0 0 0 0 0 0 0 0 0 0 0 0 0 3 4 4 4 4 2
2 3 0 0 0 0 3 0 0 0 0 0 0 0 0 0 0 0 0 0 0 0 0 0 3 0 2 0 0 2
2 3 0 0 0 0 3 0 0 0 0 0 0 0 0 0 0 0 0 0 8 0 0 0 3 0 2 5 5 2
2 3 0 5 0 0 3 1 1 1 1 0 0 5 0 0 5 3 1 1 1 1 1 7 1 3 1 1 1 2
2 3 1 1 0 0 3 0 0 0 1 1 1 1 1 1 1 1 1 0 0 0 0 0 0 3 3 1 7 2
2 3 0 0 0 0 3 0 0 0 0 0 0 0 0 0 0 0 0 0 0 0 0 0 0 0 3 3 7 2
2 3 0 0 0 0 0 3 4 4 4 4 4 4 4 4 4 4 4 4 4 4 4 4 4 4 4 3 3 2
2 3 0 0 0 0 0 3 0 0 0 0 0 0 0 0 0 0 0 0 0 0 0 0 0 0 0 0 3 2
2 3 0 0 0 0 0 3 0 5 0 0 0 0 0 0 0 8 0 0 0 5 0 0 0 0 0 5 3 2
2 3 0 0 0 0 0 1 1 1 1 1 3 2 2 2 2 2 2 2 2 2 2 1 1 7 1 1 1 2
2 3 4 4 4 0 0 0 0 0 0 0 3 0 0 0 0 0 0 0 0 0 0 4 4 4 0 0 0 2
2 0 0 0 8 5 0 0 0 0 0 0 3 0 0 0 0 0 0 0 0 0 3 0 0 0 0 0 0 2
2 1 1 1 1 1 1 1 1 1 3 0 3 0 0 0 5 0 0 0 0 0 3 4 0 0 0 5 0 2
2 0 0 0 0 0 0 0 0 1 1 1 1 1 3 2 2 2 3 1 1 1 1 0 1 5 1 1 1 2
2 5 0 0 0 0 0 0 0 9 0 0 0 0 3 0 0 0 3 0 0 0 8 0 1 1 1 1 1 2
2 1 1 1 1 1 1 1 1 1 1 1 1 1 3 0 0 0 3 1 1 1 1 1 1 1 1 1 1 2
2 2 2 2 2 2 2 2 2 2 2 2 2 2 2 2 2 2 2 2 2 2 2 2 2 2 2 2 2 2