0 0 0 0 0 0 0 0 0 0 0 0 0 0 0 0 0 0 0 0 0 0 0 0 0 0 0 0 0 0
0 0 0 0 0 0 0 0 0 0 0 0 0 0 0 0 0 0 0 0 0 0 0 0 0 0 0 0 0 0
2 0 4 4 4 4 0 0 0 0 0 0 0 0 8 9 0 0 0 0 0 0 0 0 4 4 4 4 0 2
2 3 0 0 0 0 1 1 3 5 0 0 0 0 0 0 0 0 0 0 5 3 1 1 0 0 0 0 3 2
2 3 0 0 0 0 1 1 3 5 0 0 0 0 0 0 0 0 0 0 5 3 1 1 0 0 0 0 3 2
2 3 0 0 0 0 0 1 1 3 5 0 0 0 0 0 0 0 0 5 3 1 1 0 0 0 0 0 3 2
2 3 5 0 5 0 0 1 1 3 5 0 0 0 0 0 0 0 0 5 3 1 1 0 0 5 0 5 3 2
2 3 1 1 1 1 3 0 1 1 3 5 0 0 0 0 0 0 5 3 1 1 0 3 1 1 1 1 3 2
2 3 5 0 0 5 3 0 1 1 3 5 0 0 0 0 0 0 5 3 1 1 0 3 5 0 0 5 3 2
2 3 1 1 1 1 1 3 0 1 1 3 5 0 0 0 0 5 3 1 1 0 3 1 1 1 1 1 3 2
2 3 5 8 0 8 5 3 0 1 1 3 5 0 0 0 0 5 3 1 1 0 3 5 8 0 8 5 3 2
2 3 1 1 1 1 1 1 3 0 1 1 3 5 0 0 5 3 1 1 0 3 1 1 1 1 1 1 3 2
2 3 5 0 0 0 0 5 3 0 1 1 3 5 0 0 5 3 1 1 0 3 5 0 0 0 0 5 3 2
2 3 1 1 1 1 1 1 1 3 0 1 1 3 5 5 3 1 1 0 3 1 1 1 1 1 1 1 3 2
2 3 5 0 0 0 0 0 5 3 0 1 1 1 1 1 1 1 1 0 3 5 0 0 0 0 0 5 3 2
2 3 1 1 1 1 1 1 1 1 3 0 1 1 1 7 1 1 0 3 1 1 1 1 1 1 1 1 3 2
2 3 5 0 0 0 0 0 0 5 3 0 5 5 1 7 5 5 0 3 5 0 0 0 0 0 0 5 3 2
2 1 1 1 1 1 1 1 1 1 1 1 1 1 2 2 1 1 6 1 1 1 1 1 1 1 1 1 1 2
2 2 2 2 2 2 2 2 2 2 2 2 2 2 2 2 2 2 2 2 2 2 2 2 2 2 2 2 2 2