0 0 0 0 0 0 0 0 0 0 0 0 0 0 0 0 0 0 0 0 0 0 0 0 0 0 0 0 0 0
2 6 0 0 0 0 0 0 0 0 0 0 0 0 0 0 0 0 0 0 0 0 0 0 0 0 0 0 0 2
2 6 0 0 0 0 0 0 8 0 0 0 0 0 0 0 0 0 0 0 0 0 0 0 0 0 0 0 0 2
2 6 1 1 1 1 1 1 1 1 1 1 2 2 2 2 2 2 1 2 2 2 2 1 2 2 2 2 3 2
2 5 0 0 0 0 0 0 0 0 0 0 0 0 0 0 0 0 0 0 0 0 0 3 0 0 0 0 3 2
2 1 1 0 0 0 0 0 0 0 0 0 2 0 0 0 5 0 0 0 0 5 4 4 4 5 0 0 3 2
2 1 1 1 1 1 3 3 1 3 3 1 1 1 1 1 1 1 1 0 0 1 0 0 0 1 0 0 3 2
2 0 0 0 0 1 3 3 0 3 3 1 0 2 2 1 1 1 1 0 0 0 0 0 8 0 0 0 3 2
2 0 0 0 0 1 3 3 5 3 3 1 0 2 0 1 1 1 1 0 1 1 1 3 1 1 1 1 3 2
2 0 0 0 0 1 1 1 1 1 1 1 0 2 5 1 1 1 0 0 0 0 0 3 0 0 0 0 3 2
2 0 0 0 0 0 0 0 0 0 0 0 0 0 0 0 0 0 0 0 0 0 0 3 0 0 0 0 3 2
2 0 0 0 0 0 0 0 9 0 0 0 0 0 0 0 1 3 1 1 1 1 1 3 2 2 2 2 3 2
2 1 1 3 1 1 1 1 1 1 1 1 3 1 1 1 0 3 0 5 5 0 0 3 0 0 0 0 3 2
2 0 0 3 0 0 0 0 0 0 0 0 3 0 0 0 0 3 0 2 2 0 0 0 0 0 1 1 3 2
2 0 0 3 1 1 5 1 0 0 0 0 3 0 0 1 1 1 0 2 2 1 1 1 1 1 1 0 3 2
2 0 0 3 1 1 1 1 0 0 0 8 3 0 0 0 5 0 0 2 2 0 0 0 0 0 0 0 3 2
2 1 1 1 1 1 1 1 1 1 1 1 1 1 1 1 1 1 1 2 2 1 1 1 1 2 2 2 2 2
2 2 2 2 2 2 2 2 2 2 2 2 2 2 2 2 2 2 2 2 2 2 2 2 2 2 2 2 2 2