0 0 0 0 0 0 0 0 0 0 0 0 0 0 0 0 0 0 0 0 0 0 0 0 0 0 0 0 0 0
0 0 0 0 0 0 0 0 0 0 0 0 0 0 0 0 0 0 0 0 0 0 0 0 0 0 0 0 0 0
2 0 0 0 0 4 4 5 0 4 4 4 4 4 4 4 4 8 4 4 4 4 4 0 4 4 4 4 4 2
2 0 0 0 3 0 5 1 5 0 0 0 0 0 0 0 0 3 4 0 1 0 4 3 0 0 5 5 5 2
2 5 9 3 0 5 1 0 1 5 0 0 0 0 0 0 3 4 0 1 1 1 0 4 3 0 0 5 5 2
2 1 1 0 5 1 0 0 0 1 5 0 0 0 0 3 4 0 1 0 0 0 1 0 4 3 0 0 5 2
2 0 8 0 7 0 0 1 0 0 1 0 0 0 3 4 0 1 1 0 0 0 1 1 0 4 3 0 8 2
2 3 1 1 0 0 1 1 1 0 0 2 2 2 4 0 0 0 1 5 5 5 1 0 0 0 4 1 3 2
2 3 0 0 0 1 0 0 0 1 0 0 0 5 0 0 0 3 3 1 1 1 0 0 0 0 0 0 3 2
2 3 0 0 4 0 1 1 1 0 0 0 5 3 0 0 3 1 1 3 1 0 0 0 0 0 0 0 3 2
2 3 0 0 0 4 0 1 0 0 0 5 3 0 0 0 3 5 5 3 0 4 4 4 4 4 4 4 3 2
2 3 0 0 0 0 4 0 0 0 5 3 0 0 0 3 2 2 2 2 3 0 0 0 0 0 0 0 3 2
2 2 2 2 3 0 0 4 4 4 3 0 0 0 0 3 5 0 0 5 3 0 4 4 4 4 4 4 3 2
2 0 0 0 3 0 0 0 0 0 0 0 0 0 3 1 1 1 1 1 1 3 0 0 0 0 0 0 3 2
2 1 1 1 3 1 1 1 3 0 0 0 0 0 3 5 0 0 0 0 5 3 0 4 4 4 4 4 3 2
2 0 0 0 0 0 0 0 3 0 0 0 0 3 2 2 2 2 2 2 2 2 3 0 0 0 0 0 3 2
2 0 0 0 0 0 0 0 3 0 0 8 0 3 5 0 0 0 8 0 0 5 3 0 4 4 4 4 3 2
2 1 1 1 1 1 1 1 1 2 2 2 2 2 1 1 1 1 1 1 1 1 3 0 0 0 0 0 3 2
2 2 2 2 2 2 2 2 2 2 2 2 2 2 2 2 2 2 2 2 2 2 2 2 2 2 2 2 2 2