0 0 0 0 0 0 0 0 0 0 0 0 0 0 0 0 0 0 0 0 0 0 0 0 0 0 0 0 0 0
0 0 0 0 0 0 0 0 0 0 0 0 0 0 0 0 0 0 0 0 0 0 0 0 0 0 0 0 0 0
2 0 0 0 0 0 0 4 4 4 4 4 4 4 4 4 4 4 5 0 0 0 0 0 0 0 0 0 0 2
2 2 2 2 2 2 2 0 0 0 1 1 0 0 0 0 0 1 2 2 2 2 2 2 1 3 0 0 0 2
2 2 4 4 4 4 4 4 0 0 5 5 0 0 0 0 0 1 0 0 0 0 0 0 1 3 0 0 0 2
2 2 3 0 0 0 0 0 0 1 1 1 7 0 0 0 0 1 0 8 0 0 0 5 1 3 0 0 0 2
2 2 3 5 5 0 0 0 0 5 0 0 5 0 0 0 0 1 1 1 1 1 1 7 1 3 0 0 0 2
2 2 2 2 2 3 0 5 0 1 7 1 1 0 0 0 0 0 0 0 0 0 0 8 3 3 0 0 0 2
2 0 0 0 0 3 0 0 0 0 0 0 0 5 0 0 0 5 0 0 0 8 4 4 0 3 0 0 0 2
2 0 0 0 0 3 0 0 0 0 0 1 2 2 2 2 2 2 2 2 2 1 4 4 0 3 0 0 0 2
2 0 0 0 0 3 5 8 0 5 0 1 8 0 0 0 0 0 5 0 0 1 0 0 0 3 0 0 0 2
2 0 0 0 0 3 1 1 1 1 3 1 1 1 1 1 1 7 1 1 1 1 0 0 0 3 0 0 0 2
2 0 0 0 0 0 1 0 0 1 3 0 0 0 0 0 0 0 0 0 0 0 0 0 0 3 0 0 0 2
2 0 0 0 0 0 1 0 0 1 3 0 0 0 0 0 0 0 0 0 0 0 0 0 0 3 0 0 0 2
2 0 0 0 0 0 1 5 5 1 3 0 0 0 0 0 0 0 0 0 0 0 0 0 0 3 0 0 0 2
2 0 0 0 0 0 1 1 7 1 3 0 0 0 0 0 0 0 0 0 0 0 0 0 0 3 0 0 0 2
2 0 0 0 0 0 0 0 0 0 3 0 0 0 0 8 0 0 9 0 0 0 0 0 0 3 0 0 0 2
2 1 1 1 2 2 2 2 2 1 1 1 2 2 2 2 1 1 1 2 2 2 2 1 1 1 2 2 2 2
2 2 2 2 2 2 2 2 2 2 2 2 2 2 2 2 2 2 2 2 2 2 2 2 2 2 2 2 2 2