0 0 0 0 0 0 0 0 0 0 0 0 0 0 0 0 0 0 0 0 0 0 0 0 0 0 0 0 0 0
2 0 0 0 0 0 0 0 0 0 0 0 0 0 6 0 0 0 0 0 0 0 0 0 0 0 0 0 0 2
2 0 0 0 0 0 0 0 0 0 0 0 0 0 6 0 0 0 0 0 0 0 0 0 0 0 0 0 0 2
2 5 0 0 0 0 0 0 0 0 0 0 0 0 6 6 0 0 0 0 0 0 0 0 0 0 0 0 5 2
2 1 3 0 3 4 4 4 4 4 4 4 4 4 4 6 4 4 4 4 4 4 4 4 4 3 0 3 1 2
2 1 1 3 3 0 8 0 0 0 0 0 0 0 0 0 0 0 0 0 0 0 0 5 0 3 3 1 1 2
2 1 1 1 3 0 3 4 4 4 4 4 4 0 4 4 4 4 4 4 4 4 4 3 0 3 1 1 1 2
2 1 1 1 1 3 3 0 5 0 0 0 0 0 0 0 0 0 0 0 0 0 0 3 3 1 1 1 1 2
2 1 1 1 1 7 3 0 3 4 4 4 4 4 4 0 4 4 4 4 4 3 8 3 7 1 1 1 1 2
2 1 1 1 1 7 1 3 3 0 0 0 0 0 0 0 0 0 0 5 0 3 3 1 7 1 1 1 1 2
2 1 1 1 1 7 1 1 3 0 3 4 4 4 0 4 4 4 4 3 0 3 1 1 7 1 1 1 1 2
2 1 1 1 1 7 1 1 1 3 3 0 5 0 0 0 0 0 0 3 3 1 1 1 7 1 1 1 1 2
2 1 1 1 1 7 1 1 1 1 3 0 3 4 4 0 4 3 0 3 1 1 1 1 7 1 1 1 1 2
2 1 1 1 1 7 1 1 1 1 1 3 3 0 0 0 0 3 3 1 1 1 1 1 7 1 1 1 1 2
2 1 1 1 1 7 1 1 1 1 1 1 3 0 0 0 0 3 1 1 1 1 1 1 7 1 1 1 1 2
2 1 1 1 1 7 1 1 1 1 1 1 1 3 9 5 3 1 1 1 1 1 1 1 7 1 1 1 1 2
2 1 1 1 1 8 0 0 0 0 0 0 0 3 1 1 3 0 0 0 0 0 0 0 0 1 1 1 1 2
2 2 2 2 2 2 2 2 2 2 2 2 2 2 2 2 2 2 2 2 2 2 2 2 2 2 2 2 2 2