0 0 0 0 0 0 0 0 0 0 0 0 0 0 0 0 0 0 0 0 0 0 0 0 0 0 0 0 0 0
2 2 0 0 0 0 0 0 0 0 0 0 0 0 0 0 0 2 2 2 2 2 2 2 2 2 2 2 6 2
2 2 8 0 0 0 0 0 0 0 0 8 0 0 0 0 0 2 0 0 5 0 2 0 0 0 0 0 6 2
2 2 2 4 4 4 4 4 4 1 1 1 1 1 3 0 9 2 0 3 2 0 2 3 2 1 1 1 6 2
2 2 1 1 1 1 1 0 0 0 5 0 0 1 1 1 2 2 0 3 2 0 2 3 2 1 1 1 6 2
2 2 0 0 0 0 1 1 1 1 1 1 0 0 0 0 0 0 0 3 2 0 2 3 2 0 0 0 6 2
2 1 1 1 3 0 0 0 0 0 0 1 1 1 1 3 0 5 0 3 2 0 2 3 2 0 5 0 6 2
2 1 0 1 1 1 2 1 3 0 0 0 0 0 0 3 1 1 1 2 2 0 2 3 2 1 1 1 6 2
2 1 0 0 5 0 0 1 1 2 1 3 0 0 0 3 0 0 0 0 2 0 2 3 2 1 1 1 6 2
2 1 1 1 1 1 0 0 0 0 1 1 1 2 1 3 0 0 0 0 2 0 2 3 2 0 0 0 6 2
2 1 0 5 0 1 2 3 1 0 0 0 0 0 1 1 2 1 1 3 2 0 2 3 2 5 5 0 6 2
2 1 1 1 0 0 0 3 1 1 2 2 1 0 0 5 0 0 2 3 2 0 2 3 2 1 1 1 6 2
2 1 0 1 2 1 1 3 0 0 0 0 1 1 1 2 2 1 2 3 2 0 2 3 2 1 1 1 6 2
2 1 0 0 0 1 1 1 2 1 1 3 0 0 5 0 0 0 2 3 2 0 2 3 2 0 1 1 6 2
2 1 0 3 1 1 0 0 0 5 1 1 1 2 2 1 3 1 2 3 2 0 2 3 2 0 0 1 6 2
2 1 0 3 1 0 0 0 0 0 0 0 0 0 0 0 3 0 5 3 2 0 0 3 0 0 0 5 6 2
2 1 5 3 1 2 1 1 1 1 2 1 1 1 1 1 2 1 1 2 2 1 1 2 1 1 1 1 1 2
2 2 2 2 2 2 2 2 2 2 2 2 2 2 2 2 2 2 2 2 2 2 2 2 2 2 2 2 2 2