0 0 0 0 0 0 0 0 0 0 0 0 0 0 0 0 0 0 0 0 0 0 0 0 0 0 0 0 0 0
0 0 0 0 0 0 0 0 0 0 0 0 0 0 0 0 0 0 0 0 0 0 0 0 0 0 0 0 0 0
2 0 6 0 0 0 0 0 0 0 0 0 0 0 0 0 0 0 0 0 0 0 0 0 0 0 0 0 0 2
2 0 0 6 0 0 0 0 0 0 0 0 0 0 0 0 0 0 0 0 0 0 0 0 0 0 0 0 0 2
2 0 3 5 0 0 0 0 5 3 0 0 0 0 0 0 5 3 0 0 0 0 0 5 3 0 0 0 0 2
2 0 5 3 0 0 0 0 3 5 0 0 0 0 0 0 3 5 0 0 0 0 0 3 5 0 0 0 0 2
2 0 3 5 0 0 0 0 5 3 0 0 0 0 0 0 5 3 0 0 0 0 0 5 3 0 0 0 0 2
2 0 5 3 0 0 0 0 3 5 0 0 0 0 0 0 3 5 0 0 0 0 0 3 5 0 0 0 0 2
2 0 3 5 0 0 0 0 5 3 0 0 0 0 0 0 5 3 0 0 0 0 0 5 3 0 0 0 0 2
2 0 5 3 0 0 0 0 3 5 0 0 0 0 0 0 3 5 0 0 0 0 0 3 5 0 0 0 0 2
2 0 3 5 0 0 0 0 5 3 0 0 0 0 0 0 5 3 0 0 0 0 0 5 3 0 0 0 0 2
2 0 5 3 0 0 0 0 3 5 0 0 0 0 0 0 3 5 0 0 0 0 0 3 5 0 0 0 0 2
2 0 3 5 0 0 0 0 5 3 0 0 0 0 0 0 5 3 0 0 0 0 0 5 3 0 0 0 0 2
2 0 5 3 0 0 0 0 3 5 0 0 0 0 0 0 3 5 0 0 0 0 0 3 5 0 0 0 0 2
2 0 3 5 0 0 0 0 5 3 0 0 0 0 0 0 5 3 0 0 0 0 0 5 3 0 0 0 0 2
2 0 5 3 0 0 0 0 3 5 0 0 0 0 0 0 3 5 0 0 0 0 0 3 5 0 0 0 0 2
2 9 3 5 0 0 0 0 5 3 0 0 0 0 0 8 5 3 0 0 0 8 0 5 3 0 0 8 0 2
2 1 1 1 1 1 1 1 1 1 1 1 1 1 1 1 1 1 1 1 1 1 1 1 1 1 1 1 1 2
2 2 2 2 2 2 2 2 2 2 2 2 2 2 2 2 2 2 2 2 2 2 2 2 2 2 2 2 2 2