0 0 0 0 0 0 0 0 0 0 0 0 0 0 0 0 0 0 0 0 0 0 0 0 0 0 0 0 0 0
2 0 0 0 0 0 0 0 0 0 0 0 0 0 0 0 0 0 0 0 0 0 0 0 0 0 0 0 0 2
2 0 0 0 0 0 0 0 0 0 8 0 0 0 0 0 8 0 0 0 0 0 0 0 0 5 0 5 6 2
2 0 0 0 0 0 0 3 1 1 1 1 1 1 1 1 1 1 1 1 1 1 0 0 3 1 1 1 1 2
2 0 0 0 0 0 0 3 0 1 1 1 1 1 1 1 1 1 1 1 1 0 0 3 1 1 1 1 1 2
2 3 1 1 1 1 1 1 0 0 1 5 1 1 5 1 1 5 1 1 0 0 3 1 1 1 1 1 1 2
2 3 1 1 1 1 1 1 1 0 0 0 0 0 0 0 0 0 0 0 8 3 1 1 1 1 1 1 1 2
2 3 1 1 1 1 1 1 1 1 1 1 1 1 1 7 1 1 1 1 1 1 1 1 1 0 0 0 0 2
2 3 1 1 1 1 1 1 1 1 5 0 5 0 0 0 0 5 0 5 1 1 1 1 1 0 5 5 0 2
2 3 1 1 1 1 1 1 1 1 1 7 1 1 1 7 1 1 1 1 1 1 1 1 1 1 1 1 1 2
2 3 0 0 0 0 0 0 0 8 0 0 0 0 0 0 0 0 0 0 5 1 1 1 1 1 1 0 0 2
2 3 0 0 3 1 1 1 1 1 3 1 1 1 1 1 3 0 0 4 3 1 1 1 1 0 0 5 3 2
2 3 0 0 3 0 0 3 0 0 3 0 0 3 0 0 3 0 0 0 1 1 1 0 0 5 3 1 1 2
2 3 0 0 3 5 5 3 5 5 3 5 5 3 5 5 3 0 0 0 1 0 0 5 3 1 1 1 1 2
2 3 0 0 3 1 1 1 1 1 3 1 1 1 1 1 3 0 0 0 0 5 3 1 1 1 1 1 1 2
2 3 0 0 0 0 0 0 0 0 0 0 0 0 0 0 9 0 0 0 3 1 1 1 1 1 1 1 1 2
2 3 1 1 1 1 1 1 1 1 1 1 1 1 1 1 1 1 1 1 1 1 1 1 1 1 1 1 1 2
2 2 2 2 2 2 2 2 2 2 2 2 2 2 2 2 2 2 2 2 2 2 2 2 2 2 2 2 2 2