0 0 0 0 0 0 0 0 0 0 0 0 0 0 0 0 0 0 0 0 0 0 0 0 0 0 0 0 0 0
0 0 0 0 0 0 0 0 0 0 0 0 0 0 0 0 0 0 0 0 0 0 0 0 0 0 0 0 0 0
2 0 0 0 0 0 0 0 0 0 0 0 0 0 3 3 4 4 4 4 3 3 3 3 3 1 1 1 1 2
2 0 0 0 0 0 0 0 0 0 0 0 0 3 1 1 3 4 4 4 3 5 5 0 3 1 1 1 1 2
2 0 0 0 0 0 0 0 0 0 0 0 3 1 1 1 1 3 0 0 0 3 3 5 3 0 3 0 3 2
2 0 0 0 0 0 0 0 0 0 0 3 1 1 1 1 1 1 3 0 0 0 0 3 3 5 3 5 3 2
2 0 0 0 0 0 0 0 0 0 0 3 1 1 1 1 1 1 3 0 0 0 0 0 3 3 3 3 3 2
2 0 0 0 0 0 0 0 0 0 0 3 1 2 1 2 7 2 3 0 0 0 0 0 3 0 3 0 3 2
2 0 0 0 0 0 0 0 0 0 0 3 5 2 1 2 7 5 3 0 0 0 0 0 3 0 3 0 3 2
2 0 0 0 0 0 0 0 0 0 0 3 1 2 1 2 7 2 3 0 0 0 0 0 3 5 3 5 3 2
2 5 4 4 4 4 4 4 4 4 4 3 1 2 1 2 7 2 3 0 0 0 0 0 3 3 3 3 3 2
2 3 5 0 0 0 0 0 0 0 0 3 5 2 1 2 7 5 3 0 0 0 0 0 3 0 3 0 3 2
2 1 3 5 0 0 0 0 0 0 0 3 1 2 1 2 7 2 3 0 0 0 0 0 3 0 3 0 3 2
2 1 1 3 5 0 0 0 0 0 0 3 1 2 1 2 7 2 3 0 0 0 0 0 3 5 3 5 3 2
2 1 1 1 3 5 0 0 0 0 0 3 5 1 1 1 7 5 3 0 0 0 0 0 3 3 3 3 3 2
2 1 1 1 1 3 5 0 0 0 0 3 1 1 1 1 1 1 3 0 0 0 0 0 3 0 3 0 3 2
2 1 1 1 1 1 3 5 0 0 3 2 1 0 1 2 0 1 2 3 0 0 0 9 3 5 3 5 3 2
2 1 1 1 1 1 1 3 0 8 3 2 1 0 1 2 0 1 2 3 8 0 3 1 1 1 1 1 1 2
2 2 2 2 2 2 2 2 2 2 2 2 2 2 2 2 2 2 2 2 2 2 2 2 2 2 2 2 2 2