0 0 0 0 0 0 0 0 0 0 0 0 0 0 0 0 0 0 0 0 0 0 0 0 0 0 0 0 0 0
0 0 0 0 0 0 0 0 0 0 0 0 0 0 0 0 0 0 0 0 0 0 0 0 0 0 0 0 0 0
2 1 6 0 0 0 0 0 0 0 0 0 0 0 0 0 0 0 0 0 0 0 0 0 0 0 0 0 1 2
2 1 6 4 4 4 4 4 4 4 4 4 4 4 4 4 4 4 4 4 4 4 4 4 4 4 4 4 1 2
2 1 6 0 0 0 0 0 0 0 7 1 1 1 3 1 1 1 7 0 0 0 0 0 0 0 0 0 1 2
2 1 6 0 0 0 0 5 7 1 7 0 0 0 3 0 0 0 7 1 1 0 5 0 0 0 0 0 1 2
2 1 6 0 0 5 7 1 7 5 5 5 5 5 3 5 5 8 5 5 1 7 1 0 5 0 0 0 1 2
2 1 6 0 1 1 7 1 7 1 1 1 1 1 3 1 1 1 1 1 1 7 1 7 1 0 5 0 1 2
2 1 1 1 1 0 0 0 0 0 0 0 0 0 3 0 0 0 0 0 0 0 0 0 1 7 1 7 1 2
2 1 1 0 0 0 0 0 5 5 5 5 0 0 3 8 0 5 5 5 5 0 0 0 0 0 1 7 1 2
2 1 0 0 0 0 3 1 1 1 1 1 1 7 3 1 1 1 1 1 1 1 3 0 0 0 0 0 1 2
2 1 0 0 0 0 3 0 0 0 0 0 0 0 3 0 0 0 0 0 0 0 3 0 0 0 0 0 1 2
2 1 0 0 0 5 3 0 0 5 5 5 5 5 3 0 5 0 5 5 5 5 3 0 8 0 0 0 1 2
2 1 0 3 7 1 1 1 1 1 1 1 1 1 3 7 1 1 1 1 1 1 1 1 1 3 0 0 1 2
2 1 0 3 0 0 0 0 0 0 0 0 0 0 3 0 0 0 0 0 0 0 0 0 0 3 0 0 1 2
2 1 0 3 0 0 0 0 0 0 0 0 0 0 3 0 0 0 0 0 0 0 0 0 0 3 0 0 1 2
2 1 0 3 0 0 0 0 0 0 0 0 0 0 3 0 0 9 0 0 0 0 0 0 0 3 0 0 1 2
2 1 1 1 1 1 1 1 1 1 1 1 1 1 1 1 1 1 1 1 1 1 1 1 1 1 1 1 1 2
2 2 2 2 2 2 2 2 2 2 2 2 2 2 2 2 2 2 2 2 2 2 2 2 2 2 2 2 2 2