0 0 0 0 0 0 0 0 0 0 0 0 0 0 0 0 0 0 0 0 0 0 0 0 0 0 0 0 0 0
2 0 0 0 0 4 4 4 4 4 4 0 0 0 0 0 0 0 0 0 0 0 0 0 0 4 0 0 0 2
2 0 1 1 1 0 0 0 0 0 0 3 4 4 0 0 0 8 0 0 3 1 1 1 1 0 0 0 0 2
2 0 1 5 0 0 0 0 0 0 3 4 4 0 1 1 1 1 1 1 3 1 1 1 1 0 0 0 0 2
2 0 1 1 1 0 0 0 0 0 4 4 0 0 7 1 1 1 1 7 3 1 5 5 1 0 0 0 0 2
2 0 0 0 0 0 1 1 1 7 0 0 0 0 7 1 1 1 1 7 3 1 1 1 1 0 0 0 0 2
2 0 0 0 0 0 1 1 1 7 0 1 1 4 7 1 5 5 1 7 3 0 0 0 0 7 1 1 1 2
2 0 0 0 0 0 1 5 5 7 0 1 1 0 7 1 1 1 1 7 3 0 0 0 0 7 1 1 1 2
2 0 0 0 0 0 1 1 1 7 0 0 0 0 0 0 0 0 0 0 3 0 0 0 0 7 5 5 1 2
2 0 0 0 0 0 0 0 0 0 0 0 0 0 0 0 0 0 0 0 3 0 0 0 0 7 1 1 1 2
2 0 0 0 0 0 0 0 0 0 7 1 1 7 0 0 0 0 0 0 3 0 0 0 0 0 0 0 0 2
2 7 1 1 1 7 0 0 0 0 7 5 5 7 0 0 0 0 0 0 3 7 1 1 1 0 0 0 0 2
2 7 1 1 1 7 0 0 0 0 7 1 1 7 0 0 0 0 0 0 3 7 1 1 1 0 1 1 0 2
2 7 0 5 0 7 0 0 0 0 0 0 0 0 0 0 0 0 0 0 3 7 5 5 1 0 1 1 0 2
2 7 1 1 1 7 0 0 0 0 0 0 0 0 0 0 0 0 0 0 3 7 1 1 1 0 0 0 0 2
2 0 0 0 0 0 0 0 0 0 0 0 0 0 0 8 0 0 0 0 3 0 9 0 0 0 0 0 0 2
2 1 1 1 1 1 1 1 1 1 1 1 1 1 1 1 1 1 1 1 1 1 1 1 1 1 1 1 1 2
2 2 2 2 2 2 2 2 2 2 2 2 2 2 2 2 2 2 2 2 2 2 2 2 2 2 2 2 2 2