0 0 0 0 0 0 0 0 0 0 0 0 0 0 0 0 0 0 0 0 0 0 0 0 0 0 0 0 0 0
2 0 0 0 0 0 0 0 0 0 0 0 0 0 0 0 0 6 0 0 0 0 0 0 0 0 0 0 0 2
2 0 8 4 0 0 0 0 0 0 0 0 0 4 9 0 0 6 0 0 0 0 0 4 0 0 0 0 0 2
2 0 3 0 3 0 0 0 0 0 0 0 3 0 3 0 0 6 0 0 0 0 3 0 3 0 0 0 3 2
2 3 0 0 3 3 0 0 0 0 0 3 0 0 0 3 0 6 0 0 0 3 0 0 0 3 0 0 3 2
2 0 1 5 3 0 3 0 0 0 3 0 1 5 1 0 3 6 0 0 3 0 1 5 1 0 3 4 3 2
2 0 1 1 3 0 0 4 4 4 3 8 1 1 1 0 3 4 4 4 3 8 1 3 1 0 0 0 3 2
2 2 1 1 3 1 1 7 1 1 2 1 1 2 1 1 2 1 1 7 1 1 2 3 1 7 1 1 3 2
2 1 0 0 3 0 0 7 0 0 1 0 0 5 1 1 1 0 0 5 1 0 1 3 0 7 0 0 3 2
2 1 4 4 3 4 4 7 4 4 1 0 3 1 4 4 4 4 3 4 4 4 4 3 4 1 4 4 3 2
2 1 0 0 3 0 0 7 0 0 1 0 3 1 0 0 1 0 3 7 3 0 1 8 0 5 0 0 3 2
2 1 7 2 3 1 2 1 7 2 1 1 3 1 1 2 1 1 2 7 3 2 1 1 2 1 7 1 3 2
2 0 7 1 1 1 1 0 0 0 1 1 3 1 1 0 0 0 1 7 3 1 1 0 0 0 7 1 3 2
2 0 0 0 3 4 4 4 0 4 4 1 3 1 4 4 0 4 4 7 3 1 4 4 0 4 4 1 3 2
2 0 0 1 3 1 0 0 5 0 0 1 3 1 0 0 5 0 0 1 3 0 0 0 5 0 0 1 3 2
2 0 5 1 3 1 0 0 2 0 0 1 3 1 0 0 2 0 0 1 3 1 0 0 2 0 0 1 3 2
2 1 7 0 3 0 7 1 2 1 1 0 3 0 1 1 2 1 1 0 3 0 1 1 2 1 7 0 3 2
2 2 2 2 2 2 2 2 2 2 2 2 2 2 2 2 2 2 2 2 2 2 2 2 2 2 2 2 2 2