0 0 0 0 0 0 0 0 0 0 0 0 0 0 0 0 0 0 0 0 0 0 0 0 0 0 0 0 0 0
2 6 0 0 0 0 0 0 0 0 0 0 0 0 0 0 0 0 0 0 0 0 0 0 0 0 0 0 0 2
2 6 0 0 0 5 0 0 0 5 0 0 0 5 8 0 8 5 0 0 0 5 0 0 0 5 0 0 0 2
2 1 1 1 1 1 1 1 1 1 1 1 1 1 1 6 1 1 1 1 1 1 1 1 1 1 1 1 1 2
2 0 0 0 0 0 0 0 0 0 0 0 0 0 0 3 0 0 0 0 0 0 0 0 0 0 0 0 0 2
2 0 0 0 0 0 0 0 0 0 0 0 0 0 1 3 1 0 0 0 0 0 0 0 0 0 0 0 0 2
2 0 0 0 0 0 0 0 0 0 0 0 0 0 5 3 5 0 0 0 0 0 0 0 0 0 0 0 0 2
2 0 0 0 8 0 0 0 0 0 0 0 0 1 1 3 1 1 0 0 0 0 0 0 0 8 0 0 0 2
2 0 0 0 3 0 0 0 0 0 0 0 0 5 0 3 0 5 0 0 0 0 0 0 0 3 0 0 0 2
2 0 0 1 3 1 0 0 0 0 0 0 1 1 1 3 1 1 1 0 0 0 0 0 1 3 1 0 0 2
2 0 0 5 3 5 0 0 0 0 0 0 5 0 0 3 0 0 5 0 0 0 0 0 5 3 5 0 0 2
2 0 1 1 3 1 1 0 0 0 0 1 1 1 1 3 1 1 1 1 0 0 0 1 1 3 1 1 0 2
2 0 5 0 3 0 5 0 0 0 0 5 0 0 0 3 0 0 0 5 0 0 0 5 0 3 0 5 0 2
2 1 1 1 3 1 1 1 0 0 1 1 1 1 1 3 1 1 1 1 1 0 1 1 1 3 1 1 1 2
2 5 0 0 3 0 0 5 0 0 5 0 0 0 0 3 0 0 0 0 5 0 5 0 0 3 0 0 5 2
2 0 0 0 3 0 0 0 0 0 0 0 0 0 0 3 0 9 0 0 0 0 0 0 0 3 0 0 0 2
2 1 1 1 1 1 1 1 1 1 1 1 1 1 1 1 1 1 1 1 1 1 1 1 1 1 1 1 1 2
2 2 2 2 2 2 2 2 2 2 2 2 2 2 2 2 2 2 2 2 2 2 2 2 2 2 2 2 2 2