0 0 0 0 0 0 0 0 0 0 0 0 0 0 0 0 0 0 0 0 0 0 0 0 0 0 0 0 0 0
2 0 4 4 4 4 5 0 0 0 0 0 0 0 0 0 0 0 0 0 0 0 0 5 0 5 9 1 6 2
2 0 0 0 0 0 1 3 0 0 0 0 0 0 0 0 0 0 0 0 0 0 3 1 1 1 1 1 6 2
2 0 0 0 0 0 1 3 0 0 0 0 0 0 0 0 0 0 0 0 0 3 7 1 1 1 1 1 6 2
2 0 0 0 0 0 1 3 0 0 0 0 0 0 0 0 0 0 0 0 3 1 7 1 1 0 0 1 6 2
2 0 0 0 0 0 1 3 0 0 0 0 0 0 0 0 0 0 0 3 1 1 7 1 1 5 0 1 6 2
2 0 5 0 8 0 1 3 0 0 0 0 0 0 0 0 0 0 3 1 5 1 7 1 1 7 7 1 6 2
2 1 1 1 1 0 0 1 3 0 0 0 0 0 0 0 0 3 1 0 3 1 7 1 1 0 0 1 6 2
2 5 0 0 0 1 5 0 1 3 5 0 0 0 0 0 3 1 0 5 3 1 7 1 1 0 0 1 6 2
2 1 1 1 3 0 1 0 0 1 1 3 0 0 0 3 1 1 1 1 3 1 7 1 1 0 0 1 6 2
2 5 0 0 1 3 0 1 5 0 1 3 5 8 3 1 0 5 0 5 3 1 7 1 1 0 0 1 6 2
2 1 1 3 0 1 3 0 1 0 0 1 1 3 1 1 1 1 1 1 3 1 7 1 1 0 0 1 6 2
2 5 0 1 3 0 1 3 0 1 5 0 1 3 0 5 0 5 0 4 3 1 7 1 1 0 0 1 6 2
2 1 3 0 1 3 0 1 3 0 1 0 1 3 1 1 1 1 1 0 3 1 7 1 1 7 7 1 6 2
2 0 1 3 0 1 3 0 1 3 0 0 0 0 0 0 0 0 0 0 3 1 7 1 1 0 0 0 6 2
2 0 0 3 0 0 3 0 0 3 0 0 0 0 0 8 0 0 0 0 3 0 0 0 0 0 0 0 6 2
2 1 1 1 1 1 1 1 1 1 1 1 1 1 1 1 1 1 1 1 1 1 1 1 1 1 1 1 1 2
2 2 2 2 2 2 2 2 2 2 2 2 2 2 2 2 2 2 2 2 2 2 2 2 2 2 2 2 2 2