0 0 0 0 0 0 0 0 0 0 0 0 0 0 0 0 0 0 0 0 0 0 0 0 0 0 0 0 0 0
2 0 0 0 0 0 0 0 0 0 0 0 0 0 0 0 0 0 0 0 0 0 0 0 0 0 0 0 0 2
2 0 0 6 0 0 0 0 0 0 0 0 0 0 0 0 0 0 0 0 0 0 0 0 0 0 0 6 0 2
2 0 0 3 1 1 1 1 1 1 1 1 1 1 1 1 1 1 1 1 1 1 1 1 1 1 1 3 0 2
2 0 0 3 0 3 1 1 0 0 0 5 0 0 0 5 0 8 0 5 0 0 0 1 1 3 0 3 0 2
2 0 0 3 1 1 1 3 1 1 1 1 1 1 1 1 1 1 1 1 1 1 1 3 1 1 1 3 0 2
2 0 0 3 0 3 0 3 0 1 1 1 0 5 0 0 0 5 8 1 1 3 0 3 0 3 0 3 0 2
2 0 0 1 1 3 1 1 1 3 0 3 1 1 1 1 1 1 1 3 0 3 1 1 1 3 1 1 0 2
2 0 0 3 0 3 0 3 0 3 0 3 0 3 1 1 1 3 0 3 0 3 0 3 0 3 0 3 0 2
2 0 0 3 1 1 1 3 1 1 1 3 0 3 0 5 0 3 0 3 1 1 1 3 1 1 1 3 0 2
2 5 0 3 0 3 0 3 0 3 0 3 8 3 2 2 2 3 8 3 0 3 0 3 0 3 0 3 5 2
2 1 1 1 1 3 1 1 1 3 5 3 2 3 2 2 2 3 2 3 5 3 1 1 1 3 1 1 1 2
2 1 1 3 0 3 0 3 0 3 2 3 2 3 2 2 2 3 2 3 2 3 0 3 0 3 0 3 1 2
2 1 1 3 1 1 0 3 2 3 2 3 2 3 2 2 2 3 2 3 2 3 2 3 0 1 1 3 1 2
2 1 1 3 0 3 2 3 2 3 2 3 2 3 2 2 2 3 2 3 2 3 2 3 2 3 0 3 1 2
2 1 1 3 2 3 0 3 0 3 0 3 0 3 0 0 9 3 0 3 0 3 0 3 0 3 2 3 1 2
2 1 1 1 1 1 1 1 1 1 1 1 1 3 1 5 1 3 1 1 1 1 1 1 1 1 1 1 1 2
2 2 2 2 2 2 2 2 2 2 2 2 2 2 2 2 2 2 2 2 2 2 2 2 2 2 2 2 2 2