0 0 0 0 0 0 0 0 0 0 0 0 0 0 0 0 0 0 0 0 0 0 0 0 0 0 0 0 0 0
2 0 4 4 4 4 4 4 4 4 5 5 1 1 1 1 1 1 5 5 4 4 4 4 4 4 4 4 0 2
2 3 0 0 0 0 0 0 0 5 1 1 1 3 3 3 3 1 1 1 5 0 0 0 0 0 0 0 3 2
2 3 0 0 0 0 0 0 5 1 1 3 3 3 8 8 3 3 3 1 1 5 0 0 0 0 0 0 3 2
2 3 0 0 0 0 0 0 1 1 3 3 0 0 0 0 0 0 3 3 1 1 0 0 0 0 0 0 3 2
2 3 0 0 0 0 0 5 1 3 3 0 0 0 0 0 0 0 0 3 3 1 5 0 0 0 0 0 3 2
2 3 0 0 0 0 0 1 1 3 5 0 0 0 0 0 0 0 0 5 3 1 1 0 0 0 0 0 3 2
2 3 0 0 0 0 0 1 3 3 5 0 0 0 0 0 0 0 0 5 3 3 1 0 0 0 0 0 3 2
2 3 0 0 0 0 0 1 3 5 5 0 0 0 0 0 0 0 0 5 5 3 1 0 0 0 0 0 3 2
2 3 0 0 0 0 0 1 3 3 5 0 0 0 0 0 0 0 0 5 3 3 1 0 0 0 0 0 3 2
2 3 0 0 0 0 0 1 1 3 5 0 0 0 0 0 0 0 0 5 3 1 1 0 0 0 0 0 3 2
2 3 0 0 0 0 0 0 1 3 3 5 0 0 0 0 0 0 5 3 3 1 0 0 0 0 0 0 3 2
2 3 0 0 0 0 0 0 1 7 3 3 5 5 0 0 5 5 3 3 7 1 0 0 0 0 0 0 3 2
2 3 0 0 0 0 0 0 0 7 1 3 3 3 5 5 3 3 3 1 7 0 0 0 0 0 0 0 3 2
2 3 0 0 0 0 0 0 0 0 1 1 1 3 3 3 3 1 1 1 0 0 0 0 0 0 0 0 3 2
2 3 9 0 0 0 0 0 0 8 0 0 1 1 1 1 1 1 0 0 8 0 0 0 0 0 0 0 3 2
2 1 1 1 1 1 1 1 1 1 3 0 0 0 0 0 0 0 0 3 1 1 1 1 1 1 1 1 1 2
2 2 2 2 2 2 2 2 2 2 2 2 2 2 2 2 2 2 2 2 2 2 2 2 2 2 2 2 2 2