0 0 0 0 0 0 0 0 0 0 0 0 0 0 0 0 0 0 0 0 0 0 0 0 0 0 0 0 0 0
2 6 0 0 0 0 0 0 0 0 0 0 0 0 0 0 0 0 0 0 0 0 0 0 0 0 0 0 0 2
2 6 4 4 4 4 4 4 4 4 4 4 4 0 0 0 0 0 0 0 0 0 0 0 0 0 0 0 0 2
2 3 0 0 0 0 0 3 0 0 0 0 0 1 0 5 0 1 0 0 0 0 0 3 0 0 0 0 0 2
2 3 0 5 0 0 3 3 3 0 0 5 0 1 1 1 1 1 0 5 0 0 3 3 3 0 0 5 0 2
2 3 0 3 3 0 0 3 0 0 3 3 0 0 0 0 0 0 0 3 3 0 0 3 0 0 3 3 0 2
2 3 0 3 0 3 3 3 3 3 0 3 0 0 0 0 0 0 0 3 0 3 3 3 3 3 0 3 0 2
2 3 0 3 0 0 5 8 5 0 0 3 0 0 0 3 0 0 0 3 0 0 5 8 5 0 0 3 0 2
2 3 0 0 3 1 1 1 1 1 3 0 0 0 3 3 3 0 0 0 3 1 1 1 1 1 3 0 0 2
2 3 0 0 0 3 3 3 3 3 0 3 3 0 0 3 0 0 3 3 0 3 3 3 3 3 0 0 0 2
2 3 0 0 0 0 0 0 0 0 0 3 0 3 3 3 3 3 0 3 0 0 0 0 0 0 0 0 0 2
2 3 0 0 0 0 5 0 0 0 0 3 0 0 5 8 5 0 0 3 0 0 0 0 0 5 0 0 0 2
2 3 1 1 1 1 1 1 3 0 0 0 3 1 1 1 1 1 3 0 0 3 1 1 1 1 1 1 1 2
2 3 0 0 0 0 0 0 3 0 0 0 0 3 3 3 3 3 0 0 0 3 0 0 0 0 0 0 0 2
2 3 0 0 0 0 0 0 3 0 0 0 0 0 0 0 0 0 0 0 0 3 0 0 0 0 0 0 0 2
2 3 0 0 0 0 0 0 3 0 0 0 0 0 0 0 5 0 0 9 0 3 0 0 0 0 0 0 0 2
2 1 1 1 1 1 1 1 1 1 1 1 1 1 1 1 1 1 1 1 1 1 1 1 1 1 1 1 1 2
2 2 2 2 2 2 2 2 2 2 2 2 2 2 2 2 2 2 2 2 2 2 2 2 2 2 2 2 2 2