0 0 0 0 0 0 0 0 0 0 0 0 0 0 0 0 0 0 0 0 0 0 0 0 0 0 0 0 0 0
0 0 0 0 0 0 0 0 0 0 0 0 0 0 0 0 0 0 0 0 0 0 0 0 0 0 0 0 0 0
2 0 0 0 0 0 0 0 0 0 0 0 0 0 0 0 0 6 0 0 0 0 0 0 0 0 0 0 0 2
2 0 0 0 0 0 0 0 0 0 0 0 0 0 0 0 6 6 0 0 0 0 0 0 0 0 0 0 0 2
2 0 0 0 0 0 0 0 0 0 0 0 0 0 0 6 6 0 0 0 0 0 0 0 0 0 0 0 0 2
2 0 0 0 0 0 0 0 0 0 0 0 0 0 6 6 0 0 0 0 0 0 0 0 0 0 0 0 0 2
2 0 0 0 0 0 0 0 0 0 0 0 0 6 6 0 0 0 0 0 0 0 0 0 0 0 0 0 0 2
2 0 0 0 0 0 0 0 0 0 0 0 0 6 0 0 0 0 0 0 0 0 0 0 0 0 0 0 0 2
2 0 0 0 0 0 0 0 0 0 0 3 1 1 3 0 0 0 0 0 0 0 0 0 0 0 0 0 0 2
2 0 0 0 0 0 0 0 0 0 0 3 1 1 3 5 0 0 0 0 0 0 0 0 0 0 0 0 0 2
2 0 0 0 0 0 0 0 3 1 1 1 1 1 1 1 3 0 0 8 0 0 0 0 0 0 0 0 0 2
2 0 1 3 0 0 8 0 3 1 0 5 0 5 0 1 3 0 1 3 1 3 0 0 0 0 0 0 0 2
2 0 0 1 1 1 3 1 1 1 1 1 1 1 1 1 1 1 1 3 1 1 1 3 0 0 0 0 0 2
2 0 0 0 1 1 0 5 0 0 1 1 1 1 0 5 0 0 0 3 5 0 0 1 1 3 0 0 0 2
2 0 0 0 0 1 1 1 1 3 0 0 5 0 1 1 1 3 0 3 1 1 3 0 1 3 0 0 0 2
2 0 0 0 0 0 1 5 1 3 1 1 1 3 0 5 0 3 0 3 5 1 3 5 1 3 0 0 0 2
2 0 0 8 0 0 0 1 1 1 1 1 1 1 1 1 1 1 1 1 1 1 1 1 1 3 0 9 0 2
2 2 2 2 2 2 2 2 2 2 2 2 2 2 2 2 2 2 2 2 2 2 2 2 2 2 2 2 2 2
2 2 2 2 2 2 2 2 2 2 2 2 2 2 2 2 2 2 2 2 2 2 2 2 2 2 2 2 2 2