0 0 0 0 0 0 0 0 0 0 0 0 0 0 0 0 0 0 0 0 0 0 0 0 0 0 0 0 0 0
2 0 0 0 4 4 0 5 0 0 0 0 0 0 0 0 0 4 5 0 0 0 0 5 0 0 0 0 0 2
2 0 0 3 0 0 1 1 0 0 0 0 0 0 0 0 3 0 1 1 0 0 0 1 1 3 0 0 0 2
2 0 0 3 0 0 0 0 0 0 0 0 5 8 0 0 3 0 0 0 0 0 0 0 0 3 0 0 5 2
2 0 5 3 4 4 0 0 0 0 0 0 1 1 0 5 3 0 0 8 5 0 0 0 0 3 3 1 1 2
2 1 1 3 0 0 3 5 8 0 0 0 0 0 1 1 3 0 0 1 1 0 0 0 5 0 3 0 0 2
2 0 0 0 5 0 3 1 1 0 0 0 0 0 0 0 3 0 0 0 0 0 0 1 1 0 3 0 0 2
2 0 0 1 1 0 3 4 0 4 4 8 5 4 4 4 3 0 0 0 0 0 0 0 0 0 3 0 0 2
2 0 0 5 0 0 0 0 3 0 0 1 1 0 0 0 0 5 0 0 0 5 4 0 0 0 3 5 0 2
2 0 1 1 0 0 0 0 3 0 0 0 0 0 0 0 1 1 0 0 1 1 0 3 5 3 1 1 0 2
2 0 0 0 0 4 0 5 3 0 0 5 0 0 0 0 0 0 0 0 0 0 0 3 1 1 0 0 0 2
2 0 0 0 3 0 1 1 3 0 0 1 1 0 0 0 5 0 0 0 0 0 0 3 0 0 0 0 0 2
2 0 5 0 3 0 0 0 0 0 5 0 0 0 0 1 1 0 5 0 0 0 0 3 5 0 0 0 0 2
2 3 1 1 3 0 0 0 0 1 1 0 0 0 0 0 0 0 1 1 0 0 0 3 1 1 0 0 0 2
2 3 0 0 0 0 0 0 0 0 0 0 0 0 0 0 0 0 0 0 0 0 0 0 0 0 0 0 0 2
2 3 0 0 0 0 0 0 0 0 0 0 0 0 0 9 0 0 0 0 0 0 0 0 0 0 0 0 0 2
2 1 1 1 1 1 1 1 1 1 1 1 1 1 1 1 1 1 1 1 1 1 1 1 1 1 1 1 1 2
2 2 2 2 2 2 2 2 2 2 2 2 2 2 2 2 2 2 2 2 2 2 2 2 2 2 2 2 2 2