0 0 0 0 0 0 0 0 0 0 0 0 0 0 0 0 0 0 0 0 0 0 0 0 0 0 0 0 0 0
2 0 4 0 0 8 0 0 0 1 1 1 1 0 8 0 0 5 0 0 0 1 1 1 1 0 0 0 0 2
2 3 0 3 1 1 1 1 3 1 1 1 1 3 1 1 1 1 1 1 0 1 1 1 1 1 1 1 3 2
2 3 0 3 1 1 1 1 3 0 0 5 0 3 1 1 1 5 1 1 0 1 1 1 1 5 1 1 3 2
2 3 0 3 1 5 5 1 3 1 1 1 1 1 1 1 1 1 1 1 0 0 0 0 1 1 1 1 3 2
2 3 0 1 1 1 1 1 3 0 0 0 0 0 4 4 4 4 4 4 4 4 4 4 4 4 4 4 3 2
2 3 0 0 0 0 0 1 3 8 0 0 0 0 0 0 0 0 5 0 0 5 0 0 0 0 0 0 0 2
2 3 1 7 1 3 0 1 3 1 1 1 1 1 7 1 1 1 1 1 1 1 3 0 5 0 5 0 0 2
2 3 5 0 1 3 0 1 3 4 4 4 4 4 0 4 4 4 4 4 3 2 2 2 2 2 2 2 2 2
2 1 1 0 1 3 0 1 3 0 0 0 0 5 0 5 0 0 0 0 3 0 0 9 5 0 0 5 0 2
2 0 0 0 5 3 0 1 3 1 1 1 1 1 7 1 1 1 1 1 3 1 1 1 1 1 1 1 3 2
2 1 1 3 2 2 0 1 3 4 4 4 4 4 4 4 4 4 4 4 3 0 0 0 0 0 0 0 3 2
2 1 1 3 0 0 0 5 3 0 0 0 0 5 0 0 0 0 0 2 1 1 1 1 1 1 3 0 3 2
2 1 1 3 1 1 1 1 1 1 1 1 1 1 1 1 1 1 6 2 0 0 0 0 5 0 3 0 3 2
2 5 1 3 1 0 0 0 0 0 0 0 0 0 0 0 0 0 6 2 1 1 1 1 1 7 1 0 3 2
2 1 1 3 1 0 0 0 0 0 5 0 0 0 0 5 0 0 6 2 0 0 0 0 8 0 0 0 3 2
2 1 1 1 1 1 1 1 1 1 1 1 1 1 1 1 1 1 1 1 1 1 1 1 1 1 1 1 1 2
2 2 2 2 2 2 2 2 2 2 2 2 2 2 2 2 2 2 2 2 2 2 2 2 2 2 2 2 2 2