0 0 0 0 0 0 0 0 0 0 0 0 0 0 0 0 0 0 0 0 0 0 0 0 0 0 0 0 0 0
2 2 2 2 2 2 2 2 2 2 2 2 2 2 2 2 2 2 2 2 2 2 2 2 2 2 2 6 1 2
2 3 4 4 4 4 4 4 4 4 4 4 4 4 4 4 4 4 4 4 4 4 4 4 3 6 6 6 1 2
2 3 0 0 3 0 0 0 0 0 1 1 0 0 8 0 0 0 5 0 0 0 0 0 3 6 5 0 1 2
2 3 0 0 3 0 1 1 1 1 1 1 1 1 1 1 1 1 1 1 1 1 1 1 1 1 1 3 1 2
2 3 0 0 3 0 1 1 1 0 0 0 0 0 0 0 0 0 0 0 0 5 0 0 0 0 0 3 1 2
2 3 0 0 3 0 0 0 1 0 1 1 1 1 1 1 1 1 1 1 1 1 1 1 1 1 1 1 1 2
2 3 0 0 3 0 0 3 1 0 0 0 5 0 0 1 0 5 0 1 0 5 0 1 0 5 0 0 1 2
2 3 0 0 3 0 0 3 1 1 3 1 1 1 1 1 1 1 1 1 1 1 1 1 1 1 1 1 1 2
2 3 0 0 3 4 4 3 0 0 3 1 1 1 1 1 0 1 1 1 1 1 0 0 0 0 0 0 1 2
2 3 0 0 3 0 0 3 0 0 3 0 0 0 0 1 0 5 1 0 0 0 0 0 8 0 0 0 1 2
2 3 0 0 3 0 0 3 0 0 3 4 4 3 0 1 1 1 1 3 4 4 1 1 1 1 1 1 1 2
2 3 0 0 3 0 0 3 0 0 3 0 0 3 0 0 0 0 0 3 0 0 1 1 1 1 1 1 1 2
2 3 0 0 3 0 0 3 0 0 3 0 0 3 4 4 3 0 0 3 0 0 1 1 1 1 1 1 1 2
2 3 0 0 3 0 0 3 0 0 3 0 0 3 0 0 3 0 1 3 1 1 1 0 5 5 5 0 1 2
2 3 0 0 3 9 0 3 0 0 3 0 8 3 0 0 3 0 0 3 1 1 1 3 1 1 1 1 1 2
2 1 1 1 1 1 1 1 1 1 1 1 1 1 1 1 1 1 1 3 0 5 5 3 1 1 1 1 1 2
2 2 2 2 2 2 2 2 2 2 2 2 2 2 2 2 2 2 2 2 2 2 2 2 2 2 2 2 2 2