0 0 0 0 0 0 0 0 0 0 0 0 0 0 0 0 0 0 0 0 0 0 0 0 0 0 0 0 0 0
0 0 0 0 0 0 0 0 0 0 0 0 0 0 0 0 0 0 0 0 0 0 0 0 0 0 0 0 0 0
2 0 0 0 0 0 0 0 0 0 0 0 0 0 0 0 4 4 4 4 4 0 0 0 0 0 0 0 0 2
2 0 0 0 0 0 0 0 0 0 0 4 4 4 4 3 0 0 0 0 0 8 5 0 0 5 0 0 0 2
2 0 0 0 0 0 4 4 4 4 3 0 0 0 0 0 0 8 0 5 0 1 1 1 1 1 1 1 3 2
2 0 4 4 4 3 0 0 0 0 0 0 0 0 0 5 0 1 1 1 1 1 0 0 5 0 0 1 3 2
2 3 0 0 0 0 0 0 0 0 0 9 5 0 1 1 1 1 0 0 0 5 8 1 7 1 3 1 3 2
2 3 0 0 7 1 7 0 1 1 0 1 1 1 1 0 0 5 0 1 7 1 1 1 0 1 3 1 3 2
2 3 0 0 5 0 5 0 5 0 0 1 0 0 5 0 1 1 7 1 0 0 5 0 0 1 3 1 3 2
2 3 0 1 1 0 7 1 7 0 0 1 0 1 1 1 1 0 0 0 5 1 1 1 3 1 3 1 3 2
2 3 0 0 5 0 5 0 5 0 0 1 0 1 0 0 5 0 1 7 1 7 0 1 3 1 3 1 3 2
2 3 0 0 1 1 1 0 7 1 0 1 0 1 0 1 1 7 1 0 0 5 0 1 3 1 3 1 3 2
2 3 0 0 5 0 5 0 5 0 0 1 0 1 0 1 0 0 5 0 1 1 3 1 3 1 3 1 3 2
2 3 0 1 7 0 7 1 1 0 0 1 0 1 0 1 0 1 1 1 1 1 3 1 3 1 3 1 3 2
2 3 0 0 5 0 5 0 5 0 0 1 0 1 0 1 0 1 0 0 0 1 3 1 3 1 3 1 3 2
2 3 0 0 1 1 7 0 7 1 0 1 0 1 0 1 0 1 0 5 0 1 3 1 3 1 3 1 3 2
2 3 0 0 0 0 0 0 0 0 8 1 0 1 0 1 0 1 1 1 1 1 3 1 3 1 3 1 3 2
2 1 1 1 1 1 1 1 1 1 1 1 0 0 0 0 0 0 0 0 0 0 3 0 3 0 3 0 3 2
2 2 2 2 2 2 2 2 2 2 2 2 2 2 2 2 2 2 2 2 2 2 2 2 2 2 2 2 2 2