0 0 0 0 0 0 0 0 0 0 0 0 0 0 0 0 0 0 0 0 0 0 0 0 0 0 0 0 0 0
0 0 0 0 0 0 0 0 0 0 0 0 0 0 0 0 0 0 0 0 0 0 0 0 0 0 0 0 0 0
2 0 0 0 0 0 0 5 0 0 0 0 0 5 0 0 0 0 0 0 0 0 0 0 0 3 0 0 0 2
2 3 1 1 1 1 1 1 1 1 1 1 1 1 1 1 1 1 1 3 0 0 0 0 0 3 0 0 0 2
2 3 0 0 0 0 0 0 0 0 0 0 0 0 0 5 0 0 0 3 4 4 4 4 4 3 0 0 5 2
2 1 1 1 1 1 1 1 1 1 3 1 1 1 1 1 1 1 1 1 0 0 0 0 0 3 1 1 1 2
2 1 1 1 1 1 1 1 1 3 3 0 0 0 0 0 0 0 0 0 0 0 0 0 0 3 0 0 0 2
2 1 1 1 1 1 1 1 3 3 4 4 4 4 4 4 4 3 0 0 0 0 0 0 0 3 0 0 0 2
2 1 5 0 5 1 1 3 3 0 0 0 0 0 0 8 0 3 0 0 5 0 0 8 0 3 0 0 5 2
2 1 1 1 1 1 3 3 0 0 0 0 0 3 1 1 1 1 2 2 2 1 1 1 1 3 1 1 1 2
2 0 0 0 0 0 3 0 0 0 0 0 0 3 0 0 0 0 0 0 0 0 0 0 0 3 0 0 0 2
2 0 0 0 0 0 3 0 0 0 0 0 0 3 0 0 0 0 0 0 0 0 0 0 0 3 0 0 0 2
2 0 0 0 0 8 3 0 0 0 5 0 0 3 4 4 4 4 4 4 4 4 4 4 4 3 0 0 5 2
2 3 1 1 1 1 1 1 1 1 1 1 1 3 0 0 5 0 0 0 0 0 5 0 0 3 1 1 1 2
2 3 0 0 0 0 0 0 0 0 0 0 0 3 0 1 1 1 1 1 1 1 1 1 0 3 0 0 0 2
2 3 0 0 0 0 0 0 0 0 0 0 0 3 0 0 0 0 0 0 0 0 0 0 0 3 0 0 0 2
2 3 0 0 0 0 0 0 5 0 0 0 0 3 0 0 0 0 9 0 5 0 0 0 0 3 0 0 0 2
2 1 1 1 1 1 1 1 1 1 1 1 1 1 1 1 1 1 1 1 1 1 1 1 1 1 1 1 1 2
2 2 2 2 2 2 2 2 2 2 2 2 2 2 2 2 2 2 2 2 2 2 2 2 2 2 2 2 2 2