0 0 0 0 0 0 0 0 0 0 0 0 0 0 0 0 0 0 0 0 0 0 0 0 0 0 0 0 0 0
0 0 0 0 0 0 0 0 0 0 0 0 0 0 0 0 0 0 0 0 0 0 0 0 0 0 0 0 0 0
2 0 0 0 0 0 0 0 0 0 0 0 0 0 3 3 0 0 0 0 0 0 0 0 0 0 0 0 0 2
2 0 0 8 3 0 0 0 0 0 0 0 0 0 3 3 0 0 0 0 0 0 0 0 0 3 0 8 0 2
2 0 1 1 3 1 1 0 0 0 0 0 1 1 3 3 1 1 0 0 0 0 0 1 1 3 1 1 0 2
2 1 1 5 3 5 1 1 0 0 0 1 1 1 3 3 1 1 1 0 0 0 1 1 5 3 5 1 1 2
2 1 0 0 3 0 0 0 0 0 1 1 5 0 3 3 0 5 1 1 0 0 1 0 0 3 0 0 0 2
2 1 1 5 3 5 0 4 4 4 1 1 0 0 3 3 0 0 0 0 0 0 1 1 5 3 5 0 0 2
2 0 1 1 3 1 1 0 0 0 1 1 5 0 3 3 8 5 0 0 0 0 0 1 1 3 1 1 0 2
2 0 0 5 3 5 1 1 0 0 0 1 1 1 3 3 1 1 0 0 0 0 0 0 5 3 5 1 1 2
2 0 0 0 3 0 0 1 0 0 0 0 1 1 3 3 1 1 1 0 4 4 0 0 0 3 0 0 1 2
2 1 1 5 3 5 1 1 0 0 0 0 5 0 3 3 0 5 1 1 0 0 1 1 5 3 5 1 1 2
2 0 1 7 3 7 1 0 0 0 0 0 0 0 3 3 0 0 1 1 0 0 0 1 1 3 7 1 0 2
2 0 0 0 3 0 0 0 0 0 1 1 5 0 3 3 8 5 1 1 0 0 0 0 0 3 0 0 0 2
2 0 0 0 0 0 0 0 0 0 0 1 1 1 3 3 1 1 1 0 0 0 0 0 0 0 0 0 0 2
2 0 0 0 0 0 0 0 0 0 0 0 1 1 3 3 1 1 0 0 0 0 0 0 0 0 0 0 0 2
2 0 0 0 0 0 0 0 0 9 0 0 0 0 3 3 0 0 0 0 0 0 0 0 0 0 0 0 0 2
2 1 1 1 1 1 1 1 1 1 1 1 1 1 3 3 1 1 1 1 1 1 1 1 1 1 1 1 1 2
2 2 2 2 2 2 2 2 2 2 2 2 2 2 2 2 2 2 2 2 2 2 2 2 2 2 2 2 2 2