0 0 0 0 0 0 0 0 0 0 0 0 0 0 0 0 0 0 0 0 0 0 0 0 0 0 0 0 0 0
0 0 0 0 0 0 0 0 0 0 0 0 0 0 0 0 0 0 0 0 0 0 0 0 0 0 0 0 0 0
2 0 0 0 0 0 0 0 0 0 0 0 0 0 0 0 0 0 0 8 0 0 0 0 0 0 0 0 0 2
2 1 1 1 1 1 1 1 1 1 1 1 1 1 1 1 1 1 1 1 1 1 1 1 1 1 1 1 6 2
2 5 0 8 0 0 0 0 0 1 0 0 0 0 0 0 0 5 0 0 1 0 5 0 0 0 0 0 6 2
2 1 1 1 3 1 0 1 3 1 3 1 1 1 1 1 1 1 1 0 1 3 1 0 1 1 3 1 1 2
2 1 1 1 3 1 3 1 3 1 3 1 0 0 5 0 0 0 1 0 1 3 1 0 1 1 3 1 1 2
2 1 1 1 3 1 3 1 0 1 3 1 0 1 1 1 1 0 1 0 1 3 1 0 0 0 3 0 3 2
2 1 5 1 3 1 3 1 3 1 3 1 3 1 9 0 1 0 1 0 1 3 1 0 1 1 1 1 3 2
2 1 0 0 3 1 3 1 3 1 3 1 3 1 1 0 1 0 1 0 1 3 1 0 1 3 0 0 3 2
2 0 3 1 3 1 3 1 3 1 3 1 3 0 0 5 1 0 1 0 1 3 1 0 1 3 1 1 1 2
2 3 1 1 1 0 3 1 3 1 3 1 1 1 1 1 1 0 1 0 1 3 1 0 1 3 0 0 3 2
2 3 1 1 0 1 3 1 3 1 3 0 5 0 0 0 0 0 1 0 1 3 0 4 1 1 1 1 3 2
2 3 0 0 4 1 3 1 3 1 1 1 1 1 1 1 1 1 1 0 1 3 1 0 1 3 0 0 3 2
2 3 1 1 0 1 3 1 3 0 0 0 0 0 0 0 0 0 0 0 1 3 1 0 1 3 1 1 1 2
2 4 4 1 0 1 3 1 1 1 1 1 1 1 1 1 1 1 1 1 1 3 1 0 1 3 0 0 3 2
2 0 0 0 0 0 3 0 0 0 0 0 0 8 0 0 0 0 0 0 0 3 1 0 1 1 1 1 3 2
2 1 1 1 1 1 1 1 1 1 1 1 1 1 1 1 1 1 1 1 1 1 1 0 8 0 0 0 3 2
2 2 2 2 2 2 2 2 2 2 2 2 2 2 2 2 2 2 2 2 2 2 2 2 2 2 2 2 2 2