0 0 0 0 0 0 0 0 0 0 0 0 0 0 0 0 0 0 0 0 0 0 0 0 0 0 0 0 0 0
2 0 0 0 0 0 0 0 0 0 0 0 0 0 0 0 0 0 0 0 0 0 0 0 0 0 0 0 0 2
2 0 0 0 0 0 0 6 6 6 6 6 6 6 9 6 0 0 0 0 0 0 0 6 0 0 0 0 0 2
2 0 0 0 0 8 0 0 0 0 6 0 0 0 0 6 6 0 0 0 0 0 6 6 8 2 0 0 0 2
2 0 0 5 3 5 0 0 0 0 6 0 0 0 0 0 6 6 0 0 0 6 6 0 2 2 2 0 0 2
2 0 5 3 3 3 5 0 0 0 6 0 0 0 0 0 0 6 6 0 6 6 0 2 2 2 2 2 0 2
2 5 3 3 3 3 3 5 0 0 6 0 0 0 0 0 0 0 6 6 6 0 2 2 2 2 2 2 2 2
2 3 3 3 3 3 3 3 4 4 6 0 0 5 8 0 5 0 0 6 4 4 4 4 3 3 3 0 0 2
2 0 0 0 3 0 0 0 0 1 1 1 1 1 1 1 1 1 1 1 1 0 0 0 0 3 0 0 0 2
2 0 0 5 2 5 0 0 0 1 0 5 0 0 0 0 0 0 5 0 1 0 0 0 0 3 0 0 0 2
2 0 5 2 2 2 5 0 0 1 0 4 4 4 4 4 4 4 4 0 1 0 0 0 0 3 0 0 0 2
2 0 2 2 2 2 2 0 0 1 0 3 0 0 0 0 0 0 3 0 1 0 0 0 0 3 0 0 0 2
2 0 0 2 2 2 0 0 0 1 0 3 0 0 0 0 0 0 3 0 1 0 0 0 0 3 0 0 0 2
2 3 1 1 1 1 1 3 0 1 5 3 0 0 0 8 0 0 3 5 1 0 0 0 0 3 0 0 0 2
2 3 0 0 0 0 0 3 0 1 1 1 1 1 1 1 1 1 1 1 1 0 0 0 0 3 0 0 0 2
2 3 0 0 0 0 0 3 0 0 3 0 0 0 0 0 0 0 0 3 0 0 0 0 0 3 0 0 0 2
2 3 1 1 1 1 1 3 3 1 1 1 1 1 1 1 1 1 1 1 1 3 3 1 1 1 1 1 3 2
2 2 2 2 2 2 2 2 2 2 2 2 2 2 2 2 2 2 2 2 2 2 2 2 2 2 2 2 2 2