0 0 0 0 0 0 0 0 0 0 0 0 0 0 0 0 0 0 0 0 0 0 0 0 0 0 0 0 0 0
0 0 0 0 0 0 0 0 0 0 0 0 0 0 0 0 0 0 0 0 0 0 0 0 0 0 0 0 0 0
2 4 4 4 4 4 4 4 4 4 4 4 4 4 4 4 4 0 0 0 0 0 0 0 0 0 0 0 0 2
2 0 0 0 0 0 5 0 0 0 0 0 0 0 0 0 0 3 8 0 0 0 0 0 0 0 0 0 0 2
2 0 0 0 0 5 5 5 0 0 0 0 0 0 0 0 3 3 3 0 0 0 0 0 0 0 0 0 0 2
2 0 0 0 0 5 5 5 0 0 0 0 0 0 0 0 3 3 3 0 0 0 0 0 0 0 0 0 0 2
2 0 0 0 5 5 0 0 0 0 0 0 0 0 0 3 3 0 0 0 0 0 0 0 0 0 0 0 0 2
2 0 5 5 0 5 5 5 0 0 0 0 0 3 3 0 3 3 3 0 0 4 4 4 4 4 4 4 4 2
2 5 5 0 5 5 0 0 5 5 0 0 3 3 0 3 3 0 0 3 3 0 0 0 8 0 0 0 0 2
2 0 0 0 3 3 0 0 0 0 0 0 0 0 0 3 3 0 0 0 0 0 0 3 3 3 3 3 0 2
2 0 8 0 3 3 3 0 0 0 0 0 0 0 0 3 3 3 0 0 0 0 0 5 5 5 5 5 0 2
2 3 3 3 3 0 3 3 0 0 0 0 3 3 3 3 0 3 3 0 0 0 0 3 3 3 3 3 0 2
2 0 0 0 0 0 3 3 0 0 0 0 0 0 0 0 0 3 3 0 0 0 0 5 5 5 5 5 0 2
2 0 0 0 0 0 3 3 0 0 0 0 0 0 0 9 0 3 3 0 0 0 0 3 3 3 3 3 0 2
2 1 1 1 1 1 1 1 1 1 1 1 1 3 1 1 1 1 1 1 1 1 1 1 1 1 1 1 1 2
2 0 0 0 0 0 0 0 0 0 0 0 0 3 0 0 0 0 0 0 0 0 0 0 0 0 0 0 0 2
2 0 0 0 0 0 0 0 0 0 0 0 0 3 0 0 0 0 0 0 0 0 0 0 0 0 0 0 0 2
2 1 1 1 1 1 1 1 1 1 1 1 1 1 1 1 1 1 1 1 1 1 1 1 1 1 1 1 1 2
2 2 2 2 2 2 2 2 2 2 2 2 2 2 2 2 2 2 2 2 2 2 2 2 2 2 2 2 2 2