0 0 0 0 0 0 0 0 0 0 0 0 0 0 0 0 0 0 0 0 0 0 0 0 0 0 0 0 0 0
2 0 0 0 0 0 0 0 0 0 0 0 0 0 0 0 0 0 0 0 0 0 0 0 0 0 0 0 6 2
2 4 4 4 4 4 4 4 4 0 1 3 0 0 0 0 0 0 0 0 0 0 0 0 5 0 0 5 6 2
2 0 0 0 5 1 5 0 0 3 1 3 1 2 1 2 1 2 1 2 1 2 7 2 1 2 1 2 1 2
2 0 0 5 1 0 1 5 0 3 1 3 0 0 0 0 5 0 0 0 5 0 0 4 4 4 4 4 4 2
2 0 5 1 0 0 0 1 5 3 1 1 2 1 2 1 2 1 2 1 2 1 3 0 0 0 0 0 3 2
2 0 1 0 0 0 0 0 7 3 1 2 2 2 2 2 2 2 2 2 2 2 3 0 0 5 0 0 3 2
2 0 0 0 0 0 0 0 0 3 4 4 4 4 4 4 4 4 4 4 3 1 1 1 7 1 1 1 3 2
2 0 0 0 0 0 0 0 0 0 0 0 0 0 0 0 0 0 0 0 3 1 0 0 0 0 0 0 3 2
2 0 0 5 0 9 5 0 0 0 0 0 0 0 0 0 0 0 0 0 3 1 0 0 0 0 0 0 3 2
2 3 1 1 1 1 1 1 1 3 0 8 0 5 0 0 5 0 0 0 3 1 0 5 0 0 5 8 3 2
2 3 0 8 5 0 0 5 0 3 1 2 1 2 1 2 1 2 1 2 1 2 2 1 2 7 2 1 3 2
2 3 1 1 1 1 1 1 1 3 1 1 1 1 1 1 5 0 1 1 1 0 0 0 0 0 0 0 3 2
2 3 0 0 5 0 5 0 0 3 1 1 1 1 1 1 1 1 0 1 1 0 0 0 0 0 0 0 3 2
2 3 1 1 1 1 1 1 1 3 1 1 1 1 1 1 1 1 1 0 1 0 0 0 0 0 0 0 3 2
2 3 0 0 0 5 0 5 0 3 1 1 1 1 1 1 1 1 1 1 0 0 5 0 0 5 0 0 3 2
2 1 1 1 1 1 1 1 1 1 1 1 1 1 1 1 1 1 1 1 1 1 1 1 1 1 1 1 1 2
2 2 2 2 2 2 2 2 2 2 2 2 2 2 2 2 2 2 2 2 2 2 2 2 2 2 2 2 2 2