0 0 0 0 0 0 0 0 0 0 0 0 0 0 0 0 0 0 0 0 0 0 0 0 0 0 0 0 0 0
0 0 0 0 0 0 0 0 0 0 0 0 0 0 0 0 0 0 0 0 0 0 0 0 0 0 0 0 0 0
2 0 0 0 0 0 0 0 4 4 0 0 0 0 0 0 0 0 0 0 4 4 0 0 0 0 4 4 0 2
2 0 1 1 1 1 1 1 5 4 3 1 1 1 1 1 1 1 1 3 4 5 1 1 1 1 5 4 0 2
2 0 1 1 1 1 1 1 1 5 3 1 1 1 1 1 1 1 1 3 5 1 1 1 1 1 1 5 0 2
2 0 1 1 1 1 1 1 1 1 3 1 1 1 1 1 1 1 1 3 1 1 1 1 1 1 1 1 0 2
2 0 1 1 1 0 1 1 1 1 3 1 1 1 0 0 0 0 0 3 1 1 1 0 0 0 1 1 0 2
2 0 1 1 1 0 0 1 1 1 3 1 1 1 5 5 5 0 0 3 1 1 1 5 5 5 4 4 0 2
2 0 1 1 1 0 0 1 1 1 3 1 1 1 1 1 1 0 0 3 1 1 1 1 1 1 5 4 0 2
2 0 1 1 1 0 0 1 1 1 3 1 1 1 1 1 1 0 0 3 0 1 1 1 1 1 1 5 0 2
2 0 1 1 1 0 0 1 1 1 3 1 1 1 1 1 1 0 0 3 0 0 1 1 1 1 1 1 0 2
2 0 1 1 1 0 5 1 1 1 3 1 1 1 0 0 0 0 0 3 0 0 0 0 0 1 1 1 0 2
2 0 1 1 1 5 1 1 1 1 3 1 1 1 5 5 5 5 5 3 1 1 5 5 5 1 1 1 0 2
2 0 1 1 1 1 1 1 1 1 3 1 1 1 1 1 1 1 1 3 1 1 7 1 1 1 1 1 0 2
2 0 1 1 1 1 1 1 1 0 3 1 1 1 1 1 1 1 1 3 0 1 7 1 1 1 1 0 0 2
2 0 1 1 1 1 1 1 0 0 3 1 1 1 1 1 1 1 1 3 0 0 7 1 1 1 0 0 0 2
2 0 0 8 0 0 8 0 0 0 3 0 0 0 9 0 0 0 0 3 0 0 0 8 0 0 8 0 0 2
2 1 1 1 1 1 1 1 1 1 6 1 1 1 3 3 1 1 1 6 1 1 1 1 1 1 1 1 1 2
2 2 2 2 2 2 2 2 2 2 2 2 2 2 2 2 2 2 2 2 2 2 2 2 2 2 2 2 2 2