0 0 0 0 0 0 0 0 0 0 0 0 0 0 0 0 0 0 0 0 0 0 0 0 0 0 0 0 0 0
2 0 0 0 0 0 0 0 0 0 0 0 0 0 0 0 0 0 0 0 0 0 0 0 0 0 0 0 0 2
2 1 1 1 1 1 1 3 6 0 0 0 0 0 0 0 0 0 0 0 0 6 3 1 1 1 1 1 1 2
2 1 1 1 3 3 3 5 6 0 0 0 0 0 0 0 0 0 0 0 0 6 5 3 3 3 1 1 1 2
2 3 3 1 1 1 3 3 3 5 0 0 0 0 0 0 0 0 0 0 5 3 3 3 1 7 1 3 3 2
2 5 3 3 3 1 7 1 3 3 3 5 8 0 0 0 0 8 5 3 3 3 1 1 1 3 3 3 5 2
2 0 0 5 3 3 3 1 1 1 3 3 3 5 0 0 5 3 3 3 1 7 1 3 3 3 5 0 0 2
2 0 0 0 0 5 3 3 3 1 7 1 3 3 3 3 3 3 1 1 1 3 3 3 5 0 0 0 0 2
2 0 0 0 0 0 0 5 3 3 3 1 1 1 3 3 1 1 1 3 3 3 5 0 0 0 0 0 0 2
2 0 0 0 0 0 0 0 0 5 3 3 3 1 3 3 1 3 3 3 5 0 0 0 0 0 0 0 0 2
2 0 0 0 0 0 0 5 3 3 3 1 1 1 3 3 1 1 1 3 3 3 5 0 0 0 0 0 0 2
2 0 0 0 0 5 3 3 3 1 1 1 3 3 3 3 3 3 1 7 1 3 3 3 5 0 0 0 0 2
2 0 0 5 3 3 3 1 7 1 3 3 3 5 0 0 5 3 3 3 1 1 1 3 3 3 5 0 0 2
2 5 3 3 3 1 1 1 3 3 3 5 0 0 0 0 0 0 5 3 3 3 1 7 1 3 3 3 5 2
2 3 3 1 7 1 3 3 3 5 0 0 0 0 0 0 0 0 0 0 5 3 3 3 1 1 1 3 3 2
2 1 1 1 3 3 3 5 6 0 0 0 0 0 0 0 0 0 0 0 0 6 5 3 3 3 1 1 1 2
2 1 1 1 1 1 1 3 6 0 0 0 0 0 0 0 9 0 0 0 0 6 3 1 1 1 1 1 1 2
2 2 2 2 2 2 2 2 2 2 2 2 2 2 2 2 2 2 2 2 2 2 2 2 2 2 2 2 2 2