0 0 0 0 0 0 0 0 0 0 0 0 0 0 0 0 0 0 0 0 0 0 0 0 0 0 0 0 0 0
2 0 4 4 4 4 4 4 4 4 4 4 0 0 9 0 0 0 4 4 4 4 4 4 4 4 4 4 0 2
2 3 0 0 0 0 4 4 4 4 0 0 1 1 1 1 1 1 0 0 4 4 4 4 0 0 0 0 3 2
2 3 0 0 0 0 4 4 4 0 1 1 1 1 1 1 1 1 1 1 0 4 4 4 0 0 0 0 3 2
2 3 0 0 0 0 4 4 0 1 1 1 1 1 1 1 1 1 1 1 1 0 4 4 0 0 0 0 3 2
2 3 0 0 0 0 4 0 1 1 1 1 1 5 5 5 5 1 1 1 1 1 0 4 0 0 0 0 3 2
2 3 0 0 0 0 4 0 1 1 1 1 1 1 1 1 1 1 1 1 1 1 0 4 0 0 0 0 3 2
2 3 0 0 0 0 0 1 1 1 1 1 1 1 1 1 1 1 1 1 1 1 1 0 0 0 0 0 3 2
2 3 0 0 0 0 0 1 1 5 5 5 5 1 1 1 1 5 5 5 5 1 1 0 0 0 0 0 3 2
2 3 0 0 0 0 0 1 1 1 1 1 1 1 1 1 1 1 1 1 1 1 1 0 0 0 0 0 3 2
2 3 0 0 0 0 0 1 1 1 1 1 1 5 5 5 5 1 1 1 1 1 1 0 0 0 0 0 3 2
2 3 0 0 0 0 0 0 1 1 1 1 1 1 1 1 1 1 1 1 1 1 0 0 0 0 0 0 3 2
2 3 0 0 0 0 4 0 1 1 1 1 1 1 1 1 1 1 1 1 1 1 0 4 0 0 0 0 3 2
2 3 0 0 0 0 4 0 0 1 5 5 5 5 1 1 5 5 5 5 1 0 0 4 0 0 0 0 3 2
2 3 0 0 0 0 4 4 0 0 1 1 1 1 1 1 1 1 1 1 0 0 4 4 0 0 0 0 3 2
2 3 8 5 5 5 4 4 4 5 0 0 1 1 1 1 1 1 0 0 5 4 4 4 5 5 5 8 3 2
2 1 1 1 1 1 1 1 1 1 3 5 5 5 5 5 5 5 5 3 1 1 1 1 1 1 1 1 1 2
2 2 2 2 2 2 2 2 2 2 2 2 2 2 2 2 2 2 2 2 2 2 2 2 2 2 2 2 2 2