0 0 0 0 0 0 0 0 0 0 0 0 0 0 0 0 0 0 0 0 0 0 0 0 0 0 0 0 0 0
2 0 0 0 0 0 0 0 5 0 0 0 0 5 0 0 0 0 0 0 0 0 0 0 0 0 0 0 0 2
2 5 5 1 1 1 1 1 1 1 1 1 1 1 1 1 1 1 1 3 0 0 0 0 0 0 0 0 0 2
2 1 1 0 0 0 0 0 0 0 0 0 0 5 0 0 5 0 0 3 0 0 0 0 0 0 0 0 0 2
2 0 0 0 0 0 0 0 0 0 3 1 1 1 1 1 1 1 1 3 0 0 5 0 0 0 5 0 0 2
2 0 0 0 0 0 0 0 0 0 3 0 0 0 0 0 0 0 0 3 1 1 1 1 1 1 1 1 0 2
2 0 0 0 0 5 0 8 5 0 3 0 0 0 0 0 0 0 0 0 0 0 0 0 0 0 0 0 0 2
2 0 0 0 3 1 1 1 1 1 1 3 4 4 4 4 4 4 0 0 0 0 0 5 0 0 0 0 0 2
2 0 0 0 3 0 0 0 0 0 0 3 0 0 0 0 0 0 3 1 1 1 1 1 1 1 1 1 3 2
2 0 5 0 3 0 0 0 0 0 0 3 0 0 0 0 0 0 3 0 0 0 0 0 0 0 0 0 3 2
2 1 1 1 3 0 0 0 0 8 0 3 0 0 8 0 5 0 3 0 0 0 0 0 0 0 5 0 3 2
2 0 0 0 0 0 0 3 1 1 1 3 1 1 1 1 1 1 3 0 0 0 0 3 1 1 1 1 1 2
2 0 0 0 0 0 0 3 4 4 4 4 4 4 4 4 0 0 0 0 5 0 0 3 0 0 0 0 0 2
2 0 0 0 0 5 0 3 5 0 0 0 0 0 0 0 3 1 1 1 1 1 1 3 0 0 0 5 0 2
2 1 1 1 1 1 1 1 3 0 0 0 0 0 0 0 3 0 0 0 0 0 0 3 1 1 1 1 1 2
2 0 0 0 0 0 0 0 3 0 0 0 0 0 0 0 3 0 0 0 0 0 0 0 0 0 0 0 0 2
2 0 0 0 0 0 0 0 3 0 0 5 0 0 9 0 3 0 0 0 0 0 0 5 0 0 0 0 0 2
2 2 2 2 2 2 2 2 2 2 2 2 2 2 2 2 2 2 2 2 2 2 2 2 2 2 2 2 2 2