0 0 0 0 0 0 0 0 0 0 0 0 0 0 0 0 0 0 0 0 0 0 0 0 0 0 0 0 0 0
2 4 4 4 4 4 4 4 4 4 4 4 0 0 0 0 0 0 0 0 0 0 0 0 0 0 0 0 0 2
2 0 0 0 0 0 0 0 0 0 0 0 3 0 0 0 0 0 1 0 0 0 4 0 4 0 0 0 0 2
2 0 0 5 0 0 5 0 0 5 0 8 3 4 4 4 4 0 1 1 1 1 0 3 0 1 1 1 1 2
2 1 1 1 1 1 1 1 1 1 1 1 0 0 0 0 0 3 1 1 1 1 0 3 0 7 1 1 1 2
2 5 5 0 0 0 0 0 0 0 5 5 0 4 4 4 4 3 1 1 1 1 0 3 0 7 1 1 1 2
2 1 1 5 0 0 0 0 0 5 1 1 3 0 0 0 0 0 1 0 1 1 0 3 0 7 5 5 1 2
2 1 1 1 5 0 0 0 5 1 1 1 3 4 4 4 4 0 1 0 1 1 0 3 0 7 1 1 1 2
2 1 1 1 1 5 0 5 1 1 1 1 0 0 0 0 0 3 1 0 1 1 0 3 0 7 5 5 1 2
2 1 1 1 1 1 5 1 1 1 1 1 0 0 8 0 0 3 1 0 1 1 0 3 0 7 1 1 1 2
2 1 1 1 1 1 1 1 1 1 1 1 3 1 1 1 1 1 1 5 5 1 0 3 0 7 5 5 1 2
2 0 0 0 0 0 0 0 0 0 0 0 3 0 0 0 0 0 1 1 1 1 0 3 0 7 1 1 1 2
2 1 6 1 0 0 0 0 9 0 0 0 3 0 0 0 0 0 0 0 0 0 8 3 0 7 5 5 1 2
2 1 6 1 1 1 1 1 1 1 1 1 1 1 3 1 1 1 1 1 1 1 1 1 1 7 1 1 1 2
2 1 6 0 0 0 0 1 1 1 5 1 1 1 3 1 1 1 1 1 5 0 0 0 0 0 0 0 0 2
2 1 6 0 0 0 0 1 1 1 1 5 1 1 3 1 1 5 0 5 1 1 3 0 0 0 0 0 5 2
2 1 6 5 0 0 5 1 1 1 1 1 0 0 3 0 0 1 1 1 1 1 1 1 1 1 1 1 1 2
2 2 2 2 2 2 2 2 2 2 2 2 2 2 2 2 2 2 2 2 2 2 2 2 2 2 2 2 2 2