0 0 0 0 0 0 0 0 0 0 0 0 0 0 0 0 0 0 0 0 0 0 0 0 0 0 0 0 0 0
2 0 0 0 0 0 0 0 0 0 0 0 0 0 6 6 0 0 0 0 0 0 0 0 0 0 0 0 0 2
2 0 0 8 0 3 3 3 3 3 0 0 5 5 6 6 5 5 0 0 3 3 3 3 3 0 8 0 0 2
2 0 0 0 0 3 3 3 3 3 0 3 1 1 1 1 1 1 3 0 3 3 3 0 3 0 0 0 0 2
2 0 0 3 1 3 0 3 0 3 0 3 0 0 5 0 0 0 3 0 3 0 3 0 3 1 3 0 0 2
2 0 0 3 1 3 0 3 0 3 0 3 1 1 1 1 1 1 3 0 3 0 3 0 3 1 3 0 0 2
2 0 0 0 1 3 0 3 0 3 4 3 0 0 9 0 5 0 3 4 3 0 3 0 3 1 0 0 0 2
2 0 0 0 5 2 0 3 0 2 4 1 1 1 1 1 1 1 1 4 2 0 3 0 2 5 0 0 0 2
2 0 0 0 7 3 0 3 0 3 4 3 1 1 1 1 1 1 3 4 3 0 3 0 3 7 0 0 0 2
2 0 0 3 7 3 0 3 0 3 4 3 1 1 1 1 1 1 3 4 3 0 3 0 3 7 3 0 0 2
2 0 0 3 3 3 0 3 0 3 0 0 3 1 7 7 1 3 0 0 3 0 3 0 3 3 3 0 0 2
2 0 0 3 3 3 0 3 0 3 0 0 3 1 7 7 1 3 0 0 3 0 3 0 3 3 3 0 0 2
2 0 0 0 3 3 0 3 0 3 0 0 0 1 5 5 1 0 0 0 3 0 3 0 3 3 0 0 0 2
2 0 0 0 0 3 3 3 0 3 0 0 0 0 0 0 0 0 0 0 3 0 3 3 3 0 0 0 0 2
2 0 0 0 0 0 3 3 3 3 0 0 0 0 0 0 0 0 0 0 3 3 3 3 0 0 0 0 0 2
2 0 0 0 0 0 0 3 3 3 0 0 0 0 0 0 0 0 0 0 3 3 3 0 0 0 0 0 0 2
2 0 0 0 0 0 0 0 8 3 1 1 1 1 1 1 1 1 1 1 3 8 0 0 0 0 0 0 0 2
2 2 2 2 2 2 2 2 2 2 2 2 2 2 2 2 2 2 2 2 2 2 2 2 2 2 2 2 2 2