0 0 0 0 0 0 0 0 0 0 0 0 0 0 0 0 0 0 0 0 0 0 0 0 0 0 0 0 0 0
0 0 0 0 0 0 0 0 0 0 0 0 0 0 0 0 0 0 0 0 0 0 0 0 0 0 0 0 0 0
2 0 0 0 0 0 0 0 0 0 0 0 0 0 0 0 0 0 0 0 0 0 0 0 0 0 0 0 0 2
2 0 0 0 0 0 0 0 0 0 0 6 6 6 6 6 6 6 6 0 0 0 0 0 0 0 0 0 0 2
2 0 0 0 0 0 0 0 0 0 0 3 1 1 1 1 1 1 3 0 0 0 0 0 0 0 0 0 0 2
2 0 0 0 0 0 0 0 0 8 0 3 1 0 8 0 0 1 3 0 8 0 0 0 0 0 0 0 0 2
2 0 0 0 0 0 0 0 0 0 0 3 1 0 0 5 0 1 3 0 0 0 0 0 0 0 0 0 0 2
2 0 0 0 0 0 3 1 1 1 1 1 1 1 1 1 1 1 1 1 1 1 1 3 0 0 0 0 0 2
2 0 0 0 0 0 3 1 0 0 0 0 1 0 0 0 0 1 0 0 0 0 1 3 0 0 0 0 0 2
2 0 0 0 0 0 3 1 0 0 0 0 1 0 0 0 0 1 0 0 0 0 1 3 0 0 0 0 0 2
2 0 0 0 0 0 3 1 0 0 0 0 1 0 0 0 0 1 0 0 0 0 1 3 0 0 0 0 0 2
2 0 0 0 0 0 3 1 0 0 5 0 1 8 0 5 0 1 0 0 5 0 1 3 0 0 0 0 0 2
2 3 1 1 1 1 1 1 1 1 1 1 1 1 1 7 1 1 1 1 1 1 1 1 1 1 1 1 3 2
2 3 1 0 0 0 0 1 0 0 0 0 1 0 0 0 0 1 0 0 0 0 1 0 0 0 0 1 3 2
2 3 1 0 0 0 0 1 0 0 0 0 1 0 0 0 0 1 0 0 0 0 1 0 0 0 0 1 3 2
2 3 1 0 0 5 0 1 0 0 5 0 1 0 0 5 0 1 0 0 5 0 1 0 0 5 0 1 3 2
2 3 1 3 1 1 3 1 3 1 1 3 1 3 1 1 3 1 3 1 1 3 1 3 1 1 3 1 3 2
2 3 0 3 1 1 3 0 3 1 1 3 9 3 1 1 3 8 3 1 1 3 0 3 1 1 3 0 3 2
2 2 2 2 2 2 2 2 2 2 2 2 2 2 2 2 2 2 2 2 2 2 2 2 2 2 2 2 2 2