0 0 0 0 0 0 0 0 0 0 0 0 0 0 0 0 0 0 0 0 0 0 0 0 0 0 0 0 0 0
0 0 0 0 0 0 0 0 0 0 0 0 0 0 0 0 0 0 0 0 0 0 0 0 0 0 0 0 0 0
2 0 0 0 0 0 0 0 0 0 0 0 0 0 0 0 0 0 0 0 0 0 6 0 0 0 0 0 0 2
2 0 0 0 0 8 0 0 0 0 0 0 0 0 0 0 0 2 0 0 0 0 6 0 0 0 8 0 5 2
2 3 2 2 2 2 2 0 2 2 2 2 2 2 2 3 2 2 0 0 0 1 6 1 3 1 1 1 1 2
2 3 0 0 0 0 0 0 0 4 4 4 0 0 0 3 2 5 1 1 3 1 6 1 3 1 1 1 1 2
2 1 1 3 1 1 0 1 1 0 0 3 1 8 0 3 0 1 1 1 3 1 6 1 3 1 1 5 1 2
2 0 0 3 0 0 1 1 5 1 0 3 0 1 0 3 1 1 0 0 3 1 6 1 3 1 1 1 1 2
2 3 1 0 0 0 1 1 1 1 7 3 0 0 1 3 0 0 3 1 1 1 6 1 3 0 0 0 0 2
2 3 0 0 0 0 9 0 0 0 0 3 0 0 0 1 0 0 3 1 0 0 6 0 1 1 1 1 3 2
2 3 1 1 1 1 1 1 1 1 0 1 0 5 1 0 0 5 3 1 3 1 1 1 1 1 1 1 3 2
2 3 1 1 1 1 1 1 1 1 7 1 0 1 0 0 1 1 1 1 3 1 1 0 0 0 0 0 3 2
2 3 1 1 1 1 1 1 1 1 7 1 0 0 0 0 0 5 1 1 3 0 0 1 1 1 1 1 1 2
2 3 1 1 5 0 0 0 1 1 7 1 4 4 4 4 3 1 0 1 3 4 4 4 4 4 4 0 0 2
2 3 1 1 0 0 0 5 1 1 7 1 3 0 0 0 1 0 0 1 5 0 0 0 0 1 0 1 3 2
2 3 1 1 1 1 1 1 1 1 7 1 3 0 0 1 1 1 1 1 1 1 3 1 1 1 5 1 3 2
2 3 0 0 0 1 1 5 0 0 0 0 3 0 1 1 0 0 0 0 0 0 3 0 0 1 1 1 3 2
2 3 1 1 1 1 1 1 1 1 1 1 3 1 1 1 1 1 1 1 1 1 1 1 0 0 0 0 3 2
2 2 2 2 2 2 2 2 2 2 2 2 2 2 2 2 2 2 2 2 2 2 2 2 2 2 2 2 2 2