0 0 0 0 0 0 0 0 0 0 0 0 0 0 0 0 0 0 0 0 0 0 0 0 0 0 0 0 0 0
2 0 0 0 0 0 0 0 0 0 0 0 0 0 0 0 0 0 8 0 8 0 8 4 0 0 0 0 0 2
2 0 0 0 0 0 0 0 0 0 0 0 0 0 0 0 3 1 1 1 1 1 1 0 3 1 1 1 3 2
2 0 0 0 0 0 0 0 0 0 0 0 0 0 0 0 3 1 0 0 0 0 1 0 3 1 1 1 3 2
2 0 0 0 0 0 0 0 0 0 0 0 3 1 1 1 1 1 1 0 0 0 1 0 3 1 1 1 3 2
2 0 0 0 0 0 0 0 0 0 0 0 3 1 0 0 0 0 1 0 0 0 1 0 3 1 1 1 3 2
2 0 0 0 0 0 0 0 3 1 1 1 1 1 1 0 0 0 1 5 5 5 1 0 3 1 1 1 3 2
2 0 0 0 0 0 0 0 3 1 0 0 0 0 1 0 0 0 1 1 1 1 1 0 3 1 1 1 3 2
2 0 0 0 3 1 1 1 1 1 1 0 0 0 1 5 5 5 1 0 0 0 0 0 3 1 1 1 3 2
2 0 0 8 3 1 0 0 0 0 1 0 0 0 1 1 1 1 1 0 3 1 1 1 1 1 1 1 3 2
2 1 1 1 1 1 1 0 0 0 1 5 5 5 1 0 0 0 0 8 3 1 0 0 0 0 1 1 3 2
2 1 0 0 0 0 1 0 0 0 1 1 1 1 1 0 3 1 1 1 1 1 1 0 0 0 1 1 3 2
2 1 0 0 0 0 1 5 5 5 1 0 0 0 0 0 3 1 0 0 0 0 1 0 0 0 1 1 3 2
2 1 0 0 0 0 1 1 1 1 1 0 3 1 1 1 1 1 0 5 5 5 1 5 5 5 1 1 3 2
2 1 5 5 5 5 1 0 0 0 0 0 3 1 2 2 2 2 2 2 1 2 2 2 1 2 2 2 3 2
2 1 1 1 1 1 1 0 3 1 1 1 1 1 0 0 0 0 0 0 0 0 9 0 0 0 0 0 3 2
2 0 0 0 0 0 0 0 3 1 1 1 1 1 1 1 1 1 1 1 1 1 1 1 1 1 1 1 1 2
2 2 2 2 2 2 2 2 2 2 2 2 2 2 2 2 2 2 2 2 2 2 2 2 2 2 2 2 2 2