0 0 0 0 0 0 0 0 0 0 0 0 0 0 0 0 0 0 0 0 0 0 0 0 0 0 0 0 0 0
2 0 0 0 0 0 0 0 0 0 0 0 0 0 0 0 0 0 0 0 0 0 0 0 0 0 0 0 0 2
2 0 0 0 0 0 0 0 0 0 3 1 1 0 0 0 0 1 1 3 0 0 0 0 0 0 0 0 0 2
2 0 0 0 0 0 0 0 0 3 1 1 0 0 0 0 0 0 1 1 3 0 0 0 0 0 0 0 0 2
2 0 0 0 0 0 0 0 3 1 1 0 0 0 0 0 0 0 0 1 1 3 0 0 0 0 0 0 0 2
2 0 0 0 0 0 0 3 1 1 5 0 0 8 0 0 0 0 0 5 1 1 3 0 0 0 0 0 0 2
2 0 0 5 4 4 3 1 1 1 1 1 1 1 1 1 1 1 1 1 1 1 1 3 4 4 5 8 0 2
2 0 3 1 3 0 0 0 1 1 5 0 0 0 0 0 0 0 0 5 1 1 0 0 0 3 1 3 0 2
2 0 3 3 1 3 0 0 0 1 1 0 5 0 0 0 0 5 0 1 1 0 0 0 3 1 3 3 0 2
2 0 5 3 3 1 3 8 0 0 1 1 1 1 0 0 1 1 1 1 0 0 0 3 1 3 3 5 0 2
2 0 0 5 3 3 1 3 0 0 0 1 1 1 0 0 1 1 1 0 0 0 3 1 3 3 5 0 0 2
2 0 0 0 5 3 3 1 3 0 0 0 1 1 5 9 1 1 0 0 0 3 1 3 3 5 0 0 0 2
2 0 0 0 0 5 3 3 1 3 0 0 0 1 1 1 1 0 0 0 3 1 3 3 5 0 0 0 0 2
2 0 0 0 0 0 5 3 3 1 3 0 0 0 3 3 0 0 0 3 1 3 3 5 0 0 0 0 0 2
2 0 0 0 0 0 0 5 3 3 1 3 0 0 3 3 0 0 3 1 3 3 5 0 0 0 0 0 0 2
2 5 0 0 8 0 0 0 5 3 1 1 3 0 3 3 0 3 1 1 3 5 0 0 0 8 0 0 5 2
2 1 1 1 1 1 1 1 1 1 1 1 1 1 1 1 1 1 1 1 1 1 1 1 1 1 1 1 1 2
2 2 2 2 2 2 2 2 2 2 2 2 2 2 2 2 2 2 2 2 2 2 2 2 2 2 2 2 2 2