0 0 0 0 0 0 0 0 0 0 0 0 0 0 0 0 0 0 0 0 0 0 0 0 0 0 0 0 0 0
2 1 6 1 1 1 1 1 1 1 1 1 1 1 1 1 1 1 1 1 1 1 1 1 1 1 1 1 1 2
2 1 6 4 4 4 4 4 4 4 4 4 4 4 4 4 4 4 4 4 4 4 4 4 4 4 4 0 1 2
2 1 6 1 2 2 2 1 2 2 2 1 2 2 2 1 2 2 1 2 3 1 2 4 4 4 1 3 1 2
2 1 6 1 0 0 0 0 5 0 0 0 0 5 0 0 0 5 0 0 3 0 0 0 5 3 1 3 1 2
2 1 6 5 3 2 2 2 2 2 2 2 2 2 2 2 2 2 2 2 2 2 2 2 2 3 2 3 1 2
2 1 6 1 3 1 4 4 4 4 4 4 4 4 4 4 4 4 4 4 4 4 2 0 5 3 1 3 1 2
2 1 6 5 3 1 0 2 2 2 2 2 2 2 2 2 2 2 2 2 2 2 2 1 1 1 1 3 1 2
2 1 6 1 3 1 0 2 0 5 5 5 5 5 5 5 5 5 5 5 5 0 0 0 5 1 5 3 1 2
2 1 6 5 3 1 0 2 1 1 1 2 2 2 2 2 2 1 2 2 2 2 2 3 1 1 1 3 1 2
2 1 6 1 3 1 0 0 0 0 0 8 0 0 0 0 0 0 0 0 0 0 0 3 5 1 5 3 1 2
2 1 6 5 3 1 2 2 2 2 2 2 2 2 2 2 2 1 1 2 2 2 2 3 1 0 2 3 1 2
2 1 6 1 3 4 4 4 4 4 4 4 4 4 4 4 4 4 4 4 4 4 4 0 0 3 1 3 1 2
2 1 6 1 2 2 1 1 2 2 3 2 2 1 2 1 2 2 3 2 2 2 2 2 2 3 5 3 1 2
2 1 6 0 8 0 0 0 0 0 3 0 2 2 0 0 0 0 3 0 0 8 0 0 5 3 1 3 1 2
2 1 2 2 2 1 2 1 1 1 2 2 2 2 3 2 2 1 2 1 2 2 1 1 2 2 1 3 1 2
2 0 9 0 0 0 0 0 0 0 0 0 0 0 3 0 0 0 0 0 0 0 0 0 0 0 0 3 1 2
2 2 2 2 2 2 2 2 2 2 2 2 2 2 2 2 2 2 2 2 2 2 2 2 2 2 2 2 2 2