0 0 0 0 0 0 0 0 0 0 0 0 0 0 0 0 0 0 0 0 0 0 0 0 0 0 0 0 0 0
0 0 0 0 0 0 0 0 0 0 0 0 0 0 0 0 0 0 0 0 0 0 0 0 0 0 0 0 0 0
2 0 0 0 0 0 0 0 3 0 0 0 0 0 0 0 0 0 0 0 0 0 0 0 0 0 0 0 0 2
2 0 8 5 0 0 0 0 3 0 0 0 0 0 0 0 0 0 0 0 0 0 0 0 0 0 5 8 0 2
2 3 1 1 8 5 0 0 3 0 0 0 0 0 0 0 0 0 0 0 0 0 0 0 5 8 1 1 3 2
2 3 0 0 1 1 0 0 3 1 1 1 1 6 3 1 1 1 1 1 3 0 0 0 1 1 0 0 3 2
2 3 0 0 0 0 0 0 0 0 0 0 0 3 3 5 0 0 0 0 3 0 0 0 0 0 0 0 3 2
2 3 0 0 0 0 0 0 0 0 0 0 0 5 3 3 0 0 0 0 3 0 0 0 0 0 0 0 3 2
2 3 0 0 0 0 0 0 0 0 0 0 0 3 3 5 0 0 0 0 0 0 0 0 0 0 0 0 3 2
2 3 0 0 0 0 0 0 0 0 0 0 0 5 3 3 0 0 0 0 0 0 0 0 0 0 0 0 3 2
2 3 0 0 0 0 0 0 0 0 0 0 0 3 3 5 0 0 0 0 0 0 0 0 0 0 0 0 3 2
2 3 0 0 0 0 0 0 0 0 0 0 0 5 3 3 0 0 0 0 0 0 0 0 0 0 0 0 3 2
2 3 0 0 0 0 0 0 0 0 0 0 0 3 3 5 0 0 0 0 0 0 0 0 0 0 0 0 3 2
2 3 0 0 0 0 0 0 0 0 0 0 0 5 3 3 0 0 0 0 0 0 0 0 0 0 0 0 3 2
2 3 0 0 0 0 0 0 0 0 0 0 0 3 3 5 0 0 0 0 0 0 0 0 0 0 0 0 3 2
2 3 0 0 0 0 0 0 0 0 0 0 0 5 3 3 0 0 0 0 0 0 0 0 0 0 0 0 3 2
2 3 0 0 0 0 0 0 0 9 0 0 0 3 3 5 0 0 0 0 0 0 0 0 0 0 0 0 3 2
2 3 0 0 0 0 3 1 1 1 1 1 1 1 1 1 1 1 1 1 1 1 1 3 0 0 0 0 3 2
2 2 2 2 2 2 2 2 2 2 2 2 2 2 2 2 2 2 2 2 2 2 2 2 2 2 2 2 2 2