0 0 0 0 0 0 0 0 0 0 0 0 0 0 0 0 0 0 0 0 0 0 0 0 0 0 0 0 0 0
0 0 0 0 0 0 0 0 0 0 0 0 0 0 0 0 0 0 0 0 0 0 0 0 0 0 0 0 0 0
2 6 0 0 0 0 0 0 0 0 0 0 0 0 0 0 0 6 0 0 2 1 1 1 1 0 0 0 0 2
2 6 1 1 1 1 1 1 1 1 1 1 1 1 1 1 1 6 0 0 2 0 5 3 1 0 5 0 0 2
2 6 4 4 4 4 4 4 4 4 4 4 4 3 0 0 1 3 4 4 2 1 1 3 1 0 2 2 2 2
2 5 3 1 2 1 0 0 0 0 0 5 0 3 4 4 1 3 0 0 0 5 0 3 1 0 0 0 3 2
2 2 3 0 0 0 1 1 0 0 0 0 0 3 0 0 1 3 0 0 2 1 1 3 1 0 0 5 3 2
2 2 3 1 1 0 0 5 1 0 0 0 9 3 0 0 1 3 0 5 2 8 0 3 1 3 4 4 3 2
2 3 3 0 5 1 1 1 1 1 1 1 1 3 0 0 1 3 0 0 2 1 3 1 1 3 0 0 3 2
2 3 0 0 1 1 1 0 0 0 0 0 2 3 0 0 1 3 0 0 0 0 3 0 0 3 0 5 0 2
2 3 0 0 0 1 1 0 0 0 0 5 2 3 0 0 1 1 3 0 0 0 3 0 0 3 1 1 1 2
2 3 3 0 0 0 1 1 1 1 1 1 2 3 8 0 0 1 1 1 3 0 3 0 0 3 0 0 0 2
2 2 3 1 1 1 4 4 4 4 4 4 2 1 1 3 0 0 0 1 1 1 3 3 0 3 1 1 3 2
2 1 3 0 0 0 0 8 0 0 0 0 0 0 0 1 2 3 0 0 0 1 1 3 1 0 0 0 3 2
2 1 3 1 1 1 1 1 1 1 3 0 0 0 0 0 0 1 2 3 0 0 0 3 1 0 0 0 3 2
2 1 3 1 1 5 1 1 1 1 3 1 1 1 1 1 3 1 1 1 2 2 3 3 1 1 1 0 3 2
2 1 3 1 1 1 1 1 5 1 3 1 1 1 1 1 3 5 0 0 5 0 3 3 1 5 0 0 3 2
2 1 3 1 1 1 1 1 1 1 1 1 1 1 1 1 1 1 1 1 1 1 3 1 1 1 1 1 3 2
2 2 2 2 2 2 2 2 2 2 2 2 2 2 2 2 2 2 2 2 2 2 2 2 2 2 2 2 2 2